Rk,Player,Age,Tm,Pos,G,GS,MP,FG,FGA,FG%,3P,3PA,3P%,2P,2PA,2P%,eFG%,FT,FTA,FT%,ORB,DRB,TRB,AST,STL,BLK,TOV,PF,PTS
1,Shai Gilgeous-Alexander\gilgesh01,26,OKC,PG,76,76,2598,860,1656,0.519,163,435,0.375,697,1221,0.571,0.569,601,669,0.898,67,312,379,486,131,77,183,164,2484
2,Anthony Edwards\edwaran01,23,MIN,SG,79,79,2871,721,1612,0.447,320,811,0.395,401,801,0.501,0.547,415,496,0.837,61,389,450,359,91,51,249,150,2177
3,Nikola Jokić\jokicni01,29,DEN,C,70,70,2571,786,1364,0.576,138,331,0.417,648,1033,0.627,0.627,361,451,0.8,200,692,892,716,127,45,230,160,2071
4,Giannis Antetokounmpo\antetgi01,30,MIL,PF,67,67,2289,793,1319,0.601,14,63,0.222,779,1256,0.62,0.607,436,707,0.617,147,651,798,433,58,78,206,155,2036
5,Jayson Tatum\tatumja01,26,BOS,PF,72,72,2624,662,1465,0.452,250,728,0.343,412,737,0.559,0.537,358,440,0.814,48,575,623,431,76,38,209,157,1932
6,Devin Booker\bookede01,28,PHO,SG,75,75,2795,654,1420,0.461,183,551,0.332,471,869,0.542,0.525,432,483,0.894,76,229,305,529,67,16,220,198,1923
7,Trae Young\youngtr01,26,ATL,PG,76,76,2739,566,1376,0.411,218,642,0.34,348,734,0.474,0.491,491,561,0.875,36,200,236,880,91,12,355,145,1841
8,Tyler Herro\herroty01,25,MIA,SG,77,77,2725,651,1378,0.472,251,670,0.375,400,708,0.565,0.563,287,327,0.878,35,364,399,424,69,17,198,85,1840
9,Cade Cunningham\cunnica01,23,DET,PG,70,70,2452,684,1457,0.469,149,418,0.356,535,1039,0.515,0.521,313,370,0.846,56,369,425,638,71,53,309,195,1830
10,James Harden\hardeja01,35,LAC,PG,79,79,2789,531,1295,0.41,235,668,0.352,296,627,0.472,0.501,505,578,0.874,55,401,456,687,118,55,341,162,1802
11,Karl-Anthony Towns\townska01,29,NYK,C,72,72,2517,639,1215,0.526,142,338,0.42,497,877,0.567,0.584,339,409,0.829,212,708,920,222,71,50,192,249,1759
12,Zach LaVine\lavinza01,29,2TM,SF,74,74,2602,625,1223,0.511,239,536,0.446,386,687,0.562,0.609,235,285,0.825,22,293,315,310,58,12,208,121,1724
12,Zach LaVine\lavinza01,29,CHI,SF,42,42,1432,363,710,0.511,136,305,0.446,227,405,0.56,0.607,145,182,0.797,12,190,202,189,39,10,121,64,1007
12,Zach LaVine\lavinza01,29,SAC,SG,32,32,1170,262,513,0.511,103,231,0.446,159,282,0.564,0.611,90,103,0.874,10,103,113,121,19,2,87,57,717
13,Jalen Green\greenja05,22,HOU,SG,82,82,2697,608,1437,0.423,234,661,0.354,374,776,0.482,0.505,273,336,0.813,45,332,377,282,71,27,203,127,1723
14,Stephen Curry\curryst01,36,GSW,PG,70,70,2252,564,1258,0.448,311,784,0.397,253,474,0.534,0.572,279,299,0.933,40,270,310,421,80,30,200,95,1718
15,DeMar DeRozan\derozde01,35,SAC,SF,77,77,2768,624,1308,0.477,84,256,0.328,540,1052,0.513,0.509,378,441,0.857,50,248,298,342,62,32,105,150,1710
16,LeBron James\jamesle01,40,LAL,SF,70,70,2444,651,1270,0.513,149,396,0.376,502,874,0.574,0.571,259,331,0.782,72,474,546,575,70,39,260,99,1710
17,Donovan Mitchell\mitchdo01,28,CLE,SG,71,71,2232,585,1320,0.443,233,633,0.368,352,687,0.512,0.531,298,362,0.823,57,265,322,354,95,17,149,140,1701
18,Jalen Brunson\brunsja01,28,NYK,PG,65,65,2301,585,1200,0.488,152,397,0.383,433,803,0.539,0.551,368,448,0.821,27,160,187,475,60,8,164,138,1690
19,Kevin Durant\duranke01,36,PHO,PF,62,62,2265,592,1124,0.527,160,372,0.43,432,752,0.574,0.598,303,361,0.839,23,351,374,263,50,77,190,104,1647
20,Jaren Jackson Jr.\jacksja02,25,MEM,C,74,74,2207,592,1213,0.488,146,389,0.375,446,824,0.541,0.548,311,398,0.781,91,326,417,148,92,113,153,257,1641
21,Pascal Siakam\siakapa01,30,IND,PF,78,78,2548,613,1182,0.519,126,324,0.389,487,858,0.568,0.572,226,308,0.734,133,407,540,263,70,42,109,189,1578
22,Darius Garland\garlada01,25,CLE,PG,75,75,2301,554,1174,0.472,212,529,0.401,342,645,0.53,0.562,224,255,0.878,47,167,214,506,91,11,189,143,1544
23,Coby White\whiteco01,24,CHI,SG,74,73,2450,508,1121,0.453,216,584,0.37,292,537,0.544,0.55,277,307,0.902,25,248,273,330,69,16,177,154,1509
24,Jalen Williams\willija06,23,OKC,SG,69,69,2237,565,1168,0.484,124,340,0.365,441,828,0.533,0.537,236,299,0.789,59,310,369,354,111,46,150,158,1490
25,Austin Reaves\reaveau01,26,LAL,SG,73,73,2550,477,1037,0.46,200,531,0.377,277,506,0.547,0.556,321,366,0.877,61,268,329,421,81,22,177,151,1475
26,De'Aaron Fox\foxde01,27,2TM,PG,62,62,2241,539,1163,0.463,118,381,0.31,421,782,0.538,0.514,263,318,0.827,54,244,298,392,91,25,174,164,1459
26,De'Aaron Fox\foxde01,27,SAC,PG,45,45,1663,414,883,0.469,92,286,0.322,322,597,0.539,0.521,204,246,0.829,45,180,225,276,66,20,133,118,1124
26,De'Aaron Fox\foxde01,27,SAS,PG,17,17,578,125,280,0.446,26,95,0.274,99,185,0.535,0.493,59,72,0.819,9,64,73,116,25,5,41,46,335
27,Alperen Şengün\sengual01,22,HOU,C,76,76,2395,567,1143,0.496,21,90,0.233,546,1053,0.519,0.505,296,428,0.692,262,524,786,372,84,61,194,209,1451
28,Franz Wagner\wagnefr01,23,ORL,SF,60,60,2023,537,1161,0.463,104,352,0.295,433,809,0.535,0.507,271,311,0.871,56,286,342,284,75,21,138,147,1449
29,Damian Lillard\lillada01,34,MIL,PG,58,58,2093,444,992,0.448,197,524,0.376,247,468,0.528,0.547,362,393,0.921,29,243,272,410,70,10,162,97,1447
30,Mikal Bridges\bridgmi01,28,NYK,SF,82,82,3036,592,1183,0.5,164,463,0.354,428,720,0.594,0.57,96,118,0.814,71,188,259,306,75,43,132,127,1444
31,Jamal Murray\murraja01,27,DEN,PG,67,67,2418,531,1121,0.474,156,397,0.393,375,724,0.518,0.543,218,246,0.886,45,216,261,403,91,33,138,128,1436
32,Bam Adebayo\adebaba01,27,MIA,C,78,78,2674,540,1113,0.485,79,221,0.357,461,892,0.517,0.521,251,328,0.765,185,564,749,337,98,53,161,162,1410
33,Luka Dončić\doncilu01,25,2TM,PG,50,50,1769,461,1025,0.45,177,481,0.368,284,544,0.522,0.536,309,395,0.782,40,369,409,383,89,21,179,126,1408
33,Luka Dončić\doncilu01,25,DAL,PG,22,22,785,216,466,0.464,75,212,0.354,141,254,0.555,0.544,112,146,0.767,16,167,183,172,44,9,75,58,619
33,Luka Dončić\doncilu01,25,LAL,PG,28,28,984,245,559,0.438,102,269,0.379,143,290,0.493,0.53,197,249,0.791,24,202,226,211,45,12,104,68,789
34,Jaylen Brown\brownja02,28,BOS,SF,63,63,2158,518,1118,0.463,116,358,0.324,402,760,0.529,0.515,246,322,0.764,82,286,368,286,73,19,162,154,1398
35,Michael Porter Jr.\portemi01,26,DEN,SF,77,77,2593,528,1048,0.504,193,489,0.395,335,559,0.599,0.596,149,194,0.768,138,402,540,165,50,38,104,157,1398
36,Jordan Poole\poolejo01,25,WAS,SG,68,68,2001,457,1057,0.432,235,622,0.378,222,435,0.51,0.544,242,274,0.883,31,172,203,303,86,27,204,201,1391
37,Tyrese Maxey\maxeyty01,24,PHI,PG,52,52,1960,477,1091,0.437,161,478,0.337,316,613,0.515,0.511,254,289,0.879,15,159,174,317,91,21,124,116,1369
38,Tyrese Haliburton\halibty01,24,IND,PG,73,73,2451,476,1006,0.473,218,562,0.388,258,444,0.581,0.582,189,222,0.851,42,216,258,673,105,49,120,92,1359
39,Nikola Vučević\vucevni01,34,CHI,C,73,72,2278,550,1038,0.53,129,321,0.402,421,717,0.587,0.592,120,149,0.805,178,557,735,256,61,52,119,163,1349
40,Anfernee Simons\simonan01,25,POR,SG,70,70,2292,479,1125,0.426,215,593,0.363,264,532,0.496,0.521,175,194,0.902,25,164,189,337,60,5,143,117,1348
41,Ivica Zubac\zubaciv01,27,LAC,C,80,80,2624,592,942,0.628,0,0,,592,942,0.628,0.628,156,236,0.661,300,710,1010,214,55,90,127,168,1340
42,Domantas Sabonis\sabondo01,28,SAC,C,70,70,2429,527,893,0.59,65,156,0.417,462,737,0.627,0.627,218,289,0.754,267,705,972,423,48,26,202,229,1337
43,Malik Beasley\beaslma01,28,DET,SG,82,18,2283,461,1071,0.43,319,766,0.416,142,305,0.466,0.579,95,140,0.679,47,167,214,139,73,5,83,125,1336
44,Shaedon Sharpe\sharpsh01,21,POR,SG,72,52,2252,499,1104,0.452,147,472,0.311,352,632,0.557,0.519,190,242,0.785,68,256,324,198,62,16,150,120,1335
45,OG Anunoby\anunoog01,27,NYK,PF,74,74,2706,489,1027,0.476,171,460,0.372,318,567,0.561,0.559,183,226,0.81,97,261,358,164,110,65,102,172,1332
46,Desmond Bane\banede01,26,MEM,SG,69,68,2205,493,1018,0.484,164,418,0.392,329,600,0.548,0.565,177,198,0.894,62,356,418,369,80,28,169,164,1327
47,Evan Mobley\mobleev01,23,CLE,PF,71,71,2167,505,906,0.557,85,230,0.37,420,676,0.621,0.604,221,305,0.725,164,495,659,226,61,113,145,141,1316
48,Norman Powell\powelno01,31,LAC,SG,60,60,1958,457,945,0.484,179,428,0.418,278,517,0.538,0.578,213,265,0.804,21,169,190,125,73,9,108,114,1306
49,Miles Bridges\bridgmi02,26,CHO,PF,64,64,2029,469,1089,0.431,141,450,0.313,328,639,0.513,0.495,221,254,0.87,72,409,481,248,44,45,136,93,1300
50,Julius Randle\randlju01,30,MIN,PF,69,69,2226,455,939,0.485,108,314,0.344,347,625,0.555,0.542,270,335,0.806,144,343,487,323,47,16,196,175,1288
51,Anthony Davis\davisan02,31,2TM,PF,51,51,1706,470,910,0.516,35,124,0.282,435,786,0.553,0.536,286,369,0.775,134,456,590,181,59,110,113,98,1261
51,Anthony Davis\davisan02,31,LAL,C,42,42,1440,400,758,0.528,28,94,0.298,372,664,0.56,0.546,253,321,0.788,119,380,499,141,54,90,93,82,1081
51,Anthony Davis\davisan02,31,DAL,PF,9,9,266,70,152,0.461,7,30,0.233,63,122,0.516,0.484,33,48,0.688,15,76,91,40,5,20,20,16,180
52,Scottie Barnes\barnesc01,23,TOR,PF,65,65,2134,474,1063,0.446,76,280,0.271,398,783,0.508,0.482,228,302,0.755,109,393,502,378,93,63,185,113,1252
53,Derrick White\whitede01,30,BOS,SG,76,76,2574,424,959,0.442,265,691,0.384,159,268,0.593,0.58,135,161,0.839,67,274,341,361,72,80,131,138,1248
54,Kyrie Irving\irvinky01,32,DAL,SG,50,50,1804,447,945,0.473,144,359,0.401,303,586,0.517,0.549,196,214,0.916,60,180,240,231,66,23,111,101,1234
55,RJ Barrett\barrerj01,24,TOR,SF,58,58,1869,460,982,0.468,107,306,0.35,353,676,0.522,0.523,196,311,0.63,61,305,366,314,46,17,165,137,1223
56,Deni Avdija\avdijde01,24,POR,SF,72,54,2161,402,844,0.476,125,342,0.365,277,502,0.552,0.55,290,372,0.78,110,412,522,281,71,35,196,171,1219
57,Christian Braun\braunch01,23,DEN,SG,79,77,2675,476,821,0.58,89,224,0.397,387,597,0.648,0.634,177,214,0.827,98,312,410,205,85,37,81,170,1218
58,Paolo Banchero\banchpa01,22,ORL,PF,46,46,1582,412,911,0.452,87,272,0.32,325,639,0.509,0.5,280,385,0.727,51,294,345,219,36,28,136,97,1191
59,Stephon Castle\castlst01,20,SAS,PG,81,47,2162,423,988,0.428,95,333,0.285,328,655,0.501,0.476,249,344,0.724,89,208,297,332,74,22,177,164,1190
60,LaMelo Ball\ballla01,23,CHO,PG,47,47,1505,406,1003,0.405,179,528,0.339,227,475,0.478,0.494,193,229,0.843,47,185,232,346,54,13,167,157,1184
61,CJ McCollum\mccolcj01,33,NOP,PG,56,56,1832,444,1000,0.444,171,459,0.373,273,541,0.505,0.53,124,173,0.717,42,170,212,227,46,24,106,124,1183
62,Ja Morant\moranja01,25,MEM,PG,50,50,1519,404,889,0.454,88,285,0.309,316,604,0.523,0.504,263,319,0.824,34,171,205,364,61,12,185,113,1159
63,Collin Sexton\sextoco01,26,UTA,SG,63,61,1758,416,867,0.48,110,271,0.406,306,596,0.513,0.543,217,251,0.865,60,111,171,264,47,6,160,144,1159
64,Bennedict Mathurin\mathube01,22,IND,SF,72,49,2149,391,853,0.458,98,288,0.34,293,565,0.519,0.516,276,332,0.831,87,296,383,136,47,24,135,162,1156
65,Payton Pritchard\pritcpa01,27,BOS,PG,80,3,2271,409,866,0.472,255,626,0.407,154,240,0.642,0.62,71,84,0.845,102,205,307,279,70,14,83,118,1144
66,Naz Reid\reidna01,25,MIN,C,80,17,2200,426,923,0.462,175,462,0.379,251,461,0.544,0.556,111,143,0.776,92,388,480,181,58,72,108,189,1138
67,Keyonte George\georgke01,21,UTA,PG,67,35,2109,359,919,0.391,174,507,0.343,185,412,0.449,0.485,233,285,0.818,26,227,253,377,46,9,183,111,1125
68,Trey Murphy III\murphtr02,24,NOP,SF,53,51,1854,381,839,0.454,158,438,0.361,223,401,0.556,0.548,204,230,0.887,47,221,268,188,56,39,103,112,1124
69,Myles Turner\turnemy01,28,IND,C,72,72,2174,390,811,0.481,156,394,0.396,234,417,0.561,0.577,184,238,0.773,90,381,471,111,54,144,123,183,1120
70,Malik Monk\monkma01,26,SAC,SG,65,45,2054,412,939,0.439,139,428,0.325,273,511,0.534,0.513,154,178,0.865,30,215,245,362,61,38,159,158,1117
71,Victor Wembanyama\wembavi01,21,SAS,C,46,46,1527,408,857,0.476,142,403,0.352,266,454,0.586,0.559,158,189,0.836,82,424,506,168,52,176,149,105,1116
72,Jarrett Allen\allenja01,26,CLE,C,82,82,2296,452,640,0.706,0,5,0.0,452,635,0.712,0.706,199,277,0.718,216,582,798,158,77,73,97,127,1103
73,Quentin Grimes\grimequ01,24,2TM,SG,75,37,2013,384,823,0.467,162,421,0.385,222,402,0.552,0.565,162,214,0.757,59,265,324,228,74,22,141,138,1092
73,Quentin Grimes\grimequ01,24,DAL,SG,47,12,1070,169,365,0.463,80,201,0.398,89,164,0.543,0.573,62,81,0.765,30,149,179,101,32,10,61,78,480
73,Quentin Grimes\grimequ01,24,PHI,SG,28,25,943,215,458,0.469,82,220,0.373,133,238,0.559,0.559,100,133,0.752,29,116,145,127,42,12,80,60,612
74,De'Andre Hunter\huntede01,27,2TM,SF,64,9,1740,358,762,0.47,157,388,0.405,201,374,0.537,0.573,215,254,0.846,44,214,258,92,50,13,82,155,1088
74,De'Andre Hunter\huntede01,27,ATL,SF,37,4,1064,227,492,0.461,97,247,0.393,130,245,0.531,0.56,151,176,0.858,27,118,145,57,31,5,59,88,702
74,De'Andre Hunter\huntede01,27,CLE,SF,27,5,676,131,270,0.485,60,141,0.426,71,129,0.55,0.596,64,78,0.821,17,96,113,35,19,8,23,67,386
75,Andrew Wiggins\wiggian01,29,2TM,SF,60,60,1842,376,839,0.448,130,348,0.374,246,491,0.501,0.526,196,257,0.763,89,180,269,158,60,50,99,101,1078
75,Andrew Wiggins\wiggian01,29,GSW,SF,43,43,1296,261,588,0.444,94,248,0.379,167,340,0.491,0.524,139,179,0.777,66,131,197,102,40,33,56,70,755
75,Andrew Wiggins\wiggian01,29,MIA,SF,17,17,546,115,251,0.458,36,100,0.36,79,151,0.523,0.53,57,78,0.731,23,49,72,56,20,17,43,31,323
76,Dyson Daniels\daniedy01,21,ATL,SG,76,76,2571,455,923,0.493,80,235,0.34,375,688,0.545,0.536,83,140,0.593,124,325,449,333,229,55,155,175,1073
77,Cameron Johnson\johnsca02,28,BRK,PF,57,57,1800,355,747,0.475,159,408,0.39,196,339,0.578,0.582,201,225,0.893,54,193,247,194,53,25,99,104,1070
78,Dillon Brooks\brookdi01,29,HOU,SF,75,75,2388,384,895,0.429,186,469,0.397,198,426,0.465,0.533,99,121,0.818,75,200,275,128,60,16,76,242,1053
79,Josh Hart\hartjo01,29,NYK,SG,77,77,2897,404,770,0.525,84,252,0.333,320,518,0.618,0.579,159,205,0.776,161,576,737,453,119,27,158,201,1051
80,Brook Lopez\lopezbr01,36,MIL,C,80,80,2546,394,774,0.509,139,373,0.373,255,401,0.636,0.599,114,138,0.826,113,288,401,143,50,148,84,171,1041
81,Devin Vassell\vassede01,24,SAS,SG,64,53,1983,394,889,0.443,158,429,0.368,236,460,0.513,0.532,95,120,0.792,34,221,255,183,84,33,88,108,1041
82,Josh Giddey\giddejo01,22,CHI,PG,70,69,2117,371,798,0.465,105,278,0.378,266,520,0.512,0.531,175,224,0.781,127,439,566,503,84,45,202,122,1022
83,Harrison Barnes\barneha02,32,SAS,PF,82,82,2230,347,683,0.508,156,360,0.433,191,323,0.591,0.622,161,199,0.809,97,213,310,136,39,14,50,75,1011
84,Klay Thompson\thompkl01,34,DAL,SF,72,72,1965,361,877,0.412,216,553,0.391,145,324,0.448,0.535,67,74,0.905,44,202,246,145,50,30,88,81,1005
85,Tobias Harris\harrito02,32,DET,PF,73,73,2305,384,805,0.477,91,264,0.345,293,541,0.542,0.534,143,166,0.861,65,367,432,162,74,57,85,138,1002
86,Jaden McDaniels\mcdanja02,24,MIN,PF,82,82,2614,398,834,0.477,100,303,0.33,298,531,0.561,0.537,104,128,0.813,129,341,470,163,110,74,95,225,1000
87,Russell Westbrook\westbru01,36,DEN,PG,75,36,2092,373,831,0.449,94,291,0.323,279,540,0.517,0.505,154,233,0.661,102,268,370,457,106,37,242,188,994
88,Onyeka Okongwu\okongon01,24,ATL,C,74,40,2064,388,684,0.567,48,148,0.324,340,536,0.634,0.602,164,216,0.759,220,440,660,168,69,68,90,193,988
89,Dennis Schröder\schrode01,31,3TM,PG,75,49,2105,336,827,0.406,127,371,0.342,209,456,0.458,0.483,181,216,0.838,27,171,198,404,66,12,142,180,980
89,Dennis Schröder\schrode01,31,BRK,PG,23,23,772,147,325,0.452,58,150,0.387,89,175,0.509,0.542,72,81,0.889,4,64,68,152,26,4,59,56,424
89,Dennis Schröder\schrode01,31,GSW,SG,24,18,628,94,251,0.375,37,115,0.322,57,136,0.419,0.448,29,39,0.744,10,46,56,105,25,3,48,67,254
89,Dennis Schröder\schrode01,31,DET,PG,28,8,705,95,251,0.378,32,106,0.302,63,145,0.434,0.442,80,96,0.833,13,61,74,147,15,5,35,57,302
90,Keldon Johnson\johnske04,25,SAS,SF,77,0,1838,371,770,0.482,87,274,0.318,284,496,0.573,0.538,150,194,0.773,112,259,371,125,49,22,77,115,979
91,Amen Thompson\thompam01,22,HOU,SF,69,42,2225,388,697,0.557,25,91,0.275,363,606,0.599,0.575,169,247,0.684,192,372,564,265,97,89,138,167,970
92,Jimmy Butler\butleji01,35,2TM,SF,55,55,1746,301,597,0.504,32,104,0.308,269,493,0.546,0.531,330,392,0.842,125,171,296,298,77,18,74,52,964
92,Jimmy Butler\butleji01,35,MIA,PF,25,25,766,142,263,0.54,13,36,0.361,129,227,0.568,0.565,129,161,0.801,55,76,131,120,27,10,30,23,426
92,Jimmy Butler\butleji01,35,GSW,SF,30,30,980,159,334,0.476,19,68,0.279,140,266,0.526,0.504,201,231,0.87,70,95,165,178,50,8,44,29,538
93,Kyle Kuzma\kuzmaky01,29,2TM,PF,65,62,1936,370,848,0.436,96,313,0.307,274,535,0.512,0.493,128,202,0.634,54,316,370,152,36,19,146,119,964
93,Kyle Kuzma\kuzmaky01,29,WAS,PF,32,30,887,191,455,0.42,45,160,0.281,146,295,0.495,0.469,59,98,0.602,27,158,185,79,20,7,73,52,486
93,Kyle Kuzma\kuzmaky01,29,MIL,PF,33,32,1049,179,393,0.455,51,153,0.333,128,240,0.533,0.52,69,104,0.663,27,158,185,73,16,12,73,67,478
94,Keegan Murray\murrake02,24,SAC,PF,76,76,2610,364,820,0.444,154,449,0.343,210,371,0.566,0.538,60,72,0.833,146,361,507,109,61,69,60,186,942
95,Zaccharie Risacher\risacza01,19,ATL,SF,75,73,1843,357,779,0.458,122,344,0.355,235,435,0.54,0.537,106,149,0.711,86,182,268,92,52,37,92,149,942
96,Jalen Duren\durenja01,21,DET,C,78,78,2034,378,546,0.692,0,0,,378,546,0.692,0.692,162,242,0.669,277,530,807,209,54,89,136,251,918
97,Naji Marshall\marshna01,27,DAL,SF,69,31,1919,362,712,0.508,60,218,0.275,302,494,0.611,0.551,130,160,0.813,76,252,328,208,70,11,112,109,914
98,Aaron Wiggins\wiggiaa01,26,OKC,SG,76,26,1744,355,728,0.488,130,339,0.383,225,389,0.578,0.577,74,89,0.831,81,214,295,134,60,18,69,101,914
99,Buddy Hield\hieldbu01,32,GSW,SG,82,22,1863,328,786,0.417,203,549,0.37,125,237,0.527,0.546,53,64,0.828,51,213,264,134,69,23,91,132,912
100,Kelly Oubre Jr.\oubreke01,29,PHI,SF,60,57,2078,348,741,0.47,71,242,0.293,277,499,0.555,0.518,139,185,0.751,97,271,368,108,92,30,80,180,906
101,Bradley Beal\bealbr01,31,PHO,SG,53,38,1702,345,694,0.497,102,264,0.386,243,430,0.565,0.571,110,137,0.803,34,143,177,195,58,28,99,136,902
102,Lauri Markkanen\markkla01,27,UTA,PF,47,47,1476,296,700,0.423,138,399,0.346,158,301,0.525,0.521,162,185,0.876,72,206,278,70,33,17,66,79,892
103,Toumani Camara\camarto01,24,POR,PF,78,78,2548,328,716,0.458,135,360,0.375,193,356,0.542,0.552,91,126,0.722,173,277,450,175,116,50,109,230,882
104,Ty Jerome\jeromty01,27,CLE,SG,70,3,1392,319,618,0.516,111,253,0.439,208,365,0.57,0.606,129,148,0.872,50,123,173,237,78,3,92,102,878
105,Spencer Dinwiddie\dinwisp01,31,DAL,PG,79,30,2136,284,682,0.416,109,326,0.334,175,356,0.492,0.496,195,243,0.802,18,191,209,349,70,17,102,121,872
106,Alex Sarr\sarral01,19,WAS,C,67,67,1814,326,828,0.394,105,341,0.308,221,487,0.454,0.457,112,165,0.679,124,311,435,161,44,101,114,146,869
107,Rudy Gobert\goberru01,32,MIN,C,72,72,2388,341,510,0.669,0,0,,341,510,0.669,0.669,184,273,0.674,265,520,785,127,56,104,89,182,866
108,Tim Hardaway Jr.\hardati02,32,DET,SG,77,77,2153,276,680,0.406,168,457,0.368,108,223,0.484,0.529,124,145,0.855,18,165,183,123,38,7,48,96,844
109,Fred VanVleet\vanvlfr01,30,HOU,PG,60,60,2111,287,759,0.378,159,461,0.345,128,298,0.43,0.483,111,137,0.81,32,189,221,333,94,25,87,140,844
110,Jonas Valančiūnas\valanjo01,32,2TM,C,81,21,1524,345,627,0.55,8,37,0.216,337,590,0.571,0.557,145,165,0.879,190,437,627,164,37,46,120,181,843
110,Jonas Valančiūnas\valanjo01,32,WAS,C,49,12,983,231,422,0.547,7,27,0.259,224,395,0.567,0.556,95,106,0.896,120,284,404,108,22,28,88,97,564
110,Jonas Valančiūnas\valanjo01,32,SAC,C,32,9,541,114,205,0.556,1,10,0.1,113,195,0.579,0.559,50,59,0.847,70,153,223,56,15,18,32,84,279
111,Keon Johnson\johnske07,22,BRK,SG,79,56,1925,303,779,0.389,126,401,0.314,177,378,0.468,0.47,107,139,0.77,63,234,297,175,82,30,116,209,839
112,Scoot Henderson\hendesc01,20,POR,PG,66,10,1759,287,685,0.419,105,297,0.354,182,388,0.469,0.496,158,206,0.767,52,146,198,335,68,13,177,181,837
113,P.J. Washington\washipj01,26,DAL,PF,57,56,1835,301,665,0.453,91,239,0.381,210,426,0.493,0.521,143,198,0.722,82,360,442,131,63,60,118,131,836
114,Obi Toppin\toppiob01,26,IND,PF,79,4,1545,317,599,0.529,110,301,0.365,207,298,0.695,0.621,89,114,0.781,56,262,318,128,46,28,68,108,833
115,Tyus Jones\jonesty01,28,PHO,PG,81,58,2174,306,683,0.448,166,401,0.414,140,282,0.496,0.57,51,57,0.895,40,156,196,429,69,8,91,63,829
116,Jakob Poeltl\poeltja01,29,TOR,C,57,56,1686,363,579,0.627,1,3,0.333,362,576,0.628,0.628,97,144,0.674,189,358,547,158,66,71,111,176,824
117,Gary Trent Jr.\trentga02,26,MIL,SG,74,9,1893,283,657,0.431,180,433,0.416,103,224,0.46,0.568,78,92,0.848,20,148,168,87,72,4,42,124,824
118,Jaylen Wells\wellsja01,21,MEM,SG,79,74,2043,287,676,0.425,138,392,0.352,149,284,0.525,0.527,111,135,0.822,87,181,268,135,44,8,69,146,823
119,Kristaps Porziņģis\porzikr01,29,BOS,C,42,42,1210,277,574,0.483,103,250,0.412,174,324,0.537,0.572,161,199,0.809,68,216,284,87,31,63,53,116,818
120,Duncan Robinson\robindu01,30,MIA,SF,74,37,1785,290,663,0.437,190,483,0.393,100,180,0.556,0.581,47,53,0.887,18,149,167,176,40,6,86,135,817
121,Julian Champagnie\champju02,23,SAS,SF,82,29,1932,276,665,0.415,178,480,0.371,98,185,0.53,0.549,85,94,0.904,67,251,318,111,61,35,74,114,815
122,Santi Aldama\aldamsa01,24,MEM,PF,65,16,1660,313,648,0.483,120,326,0.368,193,322,0.599,0.576,65,94,0.691,94,322,416,188,52,29,71,76,811
123,Bub Carrington\carrica01,19,WAS,PG,82,57,2458,300,748,0.401,138,407,0.339,162,341,0.475,0.493,69,85,0.812,33,308,341,364,54,21,141,190,807
124,Kawhi Leonard\leonaka01,33,LAC,SF,37,37,1180,310,623,0.498,78,190,0.411,232,433,0.536,0.56,98,121,0.81,35,184,219,116,59,17,72,56,796
125,Georges Niang\niangge01,31,2TM,PF,79,3,1697,286,620,0.461,166,409,0.406,120,211,0.569,0.595,46,58,0.793,47,225,272,111,28,14,82,201,784
125,Georges Niang\niangge01,31,CLE,PF,51,1,1053,166,348,0.477,90,225,0.4,76,123,0.618,0.606,23,29,0.793,34,155,189,67,17,7,48,129,445
125,Georges Niang\niangge01,31,ATL,PF,28,2,644,120,272,0.441,76,184,0.413,44,88,0.5,0.581,23,29,0.793,13,70,83,44,11,7,34,72,339
126,Derrick Jones Jr.\jonesde02,27,LAC,SF,77,55,1873,310,589,0.526,78,219,0.356,232,370,0.627,0.593,83,118,0.703,93,170,263,60,79,33,66,153,781
127,Scotty Pippen Jr.\pippesc02,24,MEM,PG,79,21,1683,285,594,0.48,87,219,0.397,198,375,0.528,0.553,122,171,0.713,65,194,259,347,103,30,138,203,779
128,Gradey Dick\dickgr01,21,TOR,SG,54,54,1587,265,647,0.41,114,326,0.35,151,321,0.47,0.498,133,155,0.858,44,149,193,98,48,10,83,120,777
129,Caris LeVert\leverca01,30,2TM,SG,64,3,1596,280,599,0.467,106,284,0.373,174,315,0.552,0.556,110,155,0.71,41,162,203,215,57,33,76,99,776
129,Caris LeVert\leverca01,30,CLE,SF,38,3,904,135,298,0.453,60,148,0.405,75,150,0.5,0.554,58,83,0.699,22,85,107,140,33,19,51,48,388
129,Caris LeVert\leverca01,30,ATL,SG,26,0,692,145,301,0.482,46,136,0.338,99,165,0.6,0.558,52,72,0.722,19,77,96,75,24,14,25,51,388
130,Rui Hachimura\hachiru01,26,LAL,PF,59,57,1869,293,576,0.509,102,247,0.413,191,329,0.581,0.597,87,113,0.77,79,216,295,83,45,26,49,105,775
131,Nickeil Alexander-Walker\alexani01,26,MIN,SG,82,10,2073,270,616,0.438,141,370,0.381,129,246,0.524,0.553,92,118,0.78,54,211,265,223,50,34,99,139,773
132,Brice Sensabaugh\sensabr01,21,UTA,SF,71,15,1432,275,599,0.459,157,372,0.422,118,227,0.52,0.59,65,73,0.89,42,168,210,110,46,8,107,111,772
133,Kevin Porter Jr.\porteke02,24,2TM,SG,75,4,1482,293,652,0.449,55,177,0.311,238,475,0.501,0.492,130,169,0.769,42,236,278,256,81,13,136,119,771
133,Kevin Porter Jr.\porteke02,24,LAC,SG,45,2,884,172,407,0.423,26,106,0.245,146,301,0.485,0.455,49,76,0.645,29,131,160,144,43,11,84,70,419
133,Kevin Porter Jr.\porteke02,24,MIL,SG,30,2,598,121,245,0.494,29,71,0.408,92,174,0.529,0.553,81,93,0.871,13,105,118,112,38,2,52,49,352
134,Guerschon Yabusele\yabusgu01,29,PHI,C,70,43,1895,282,563,0.501,104,274,0.38,178,289,0.616,0.593,100,138,0.725,134,261,395,148,58,24,87,164,768
135,John Collins\collijo01,27,UTA,PF,40,31,1220,280,531,0.527,59,148,0.399,221,383,0.577,0.583,139,164,0.848,89,238,327,80,39,40,103,116,758
136,Isaiah Joe\joeis01,25,OKC,SG,74,16,1604,259,588,0.44,192,466,0.412,67,122,0.549,0.604,46,56,0.821,41,155,196,119,48,9,38,113,756
137,Jalen Wilson\wilsoja03,24,BRK,PF,79,22,2031,246,620,0.397,122,362,0.337,124,258,0.481,0.495,135,165,0.818,75,195,270,145,40,5,79,164,749
138,Max Christie\chrisma02,21,2TM,SG,78,36,2127,252,590,0.427,115,314,0.366,137,276,0.496,0.525,130,152,0.855,38,220,258,146,64,31,88,115,749
138,Max Christie\chrisma02,21,LAL,SG,46,25,1154,128,288,0.444,60,163,0.368,68,125,0.544,0.549,74,87,0.851,25,98,123,66,35,21,39,73,390
138,Max Christie\chrisma02,21,DAL,SG,32,11,973,124,302,0.411,55,151,0.364,69,151,0.457,0.502,56,65,0.862,13,122,135,80,29,10,49,42,359
139,Aaron Gordon\gordoaa01,29,DEN,PF,51,42,1447,264,497,0.531,75,172,0.436,189,325,0.582,0.607,145,179,0.81,80,167,247,164,23,14,73,82,748
140,Brandin Podziemski\podzibr01,21,GSW,SG,64,33,1716,280,629,0.445,115,309,0.372,165,320,0.516,0.537,72,95,0.758,65,260,325,220,69,13,75,95,747
141,Zion Williamson\willizi01,24,NOP,PF,30,30,857,288,508,0.567,3,13,0.231,285,495,0.576,0.57,158,241,0.656,76,140,216,159,37,27,90,82,737
142,Anthony Black\blackan01,21,ORL,PG,78,10,1887,262,620,0.423,62,195,0.318,200,425,0.471,0.473,150,197,0.761,52,178,230,240,86,48,139,166,736
143,D'Angelo Russell\russeda01,28,2TM,PG,58,36,1480,249,638,0.39,113,360,0.314,136,278,0.489,0.479,121,145,0.834,20,142,162,297,56,23,108,115,732
143,D'Angelo Russell\russeda01,28,LAL,PG,29,10,763,129,311,0.415,56,168,0.333,73,143,0.51,0.505,45,53,0.849,8,72,80,136,23,4,50,53,359
143,D'Angelo Russell\russeda01,28,BRK,PG,29,26,717,120,327,0.367,57,192,0.297,63,135,0.467,0.454,76,92,0.826,12,70,82,161,33,19,58,62,373
144,Bilal Coulibaly\coulibi01,20,WAS,SF,59,59,1948,263,624,0.421,63,224,0.281,200,400,0.5,0.472,138,185,0.746,91,203,294,199,78,41,125,139,727
145,Nic Claxton\claxtni01,25,BRK,C,70,62,1882,320,568,0.563,5,21,0.238,315,547,0.576,0.568,79,154,0.513,157,358,515,157,62,100,87,150,724
146,Moses Moody\moodymo01,22,GSW,SG,74,34,1649,246,568,0.433,126,337,0.374,120,231,0.519,0.544,106,133,0.797,52,137,189,96,59,31,54,116,724
147,Donte DiVincenzo\divindo01,28,MIN,SG,62,10,1606,250,593,0.422,174,438,0.397,76,155,0.49,0.568,49,63,0.778,32,196,228,225,73,17,99,114,723
148,Chris Paul\paulch01,39,SAS,PG,82,82,2292,249,583,0.427,140,371,0.377,109,212,0.514,0.547,85,92,0.924,33,263,296,605,103,22,129,151,723
149,T.J. McConnell\mccontj01,32,IND,PG,79,1,1415,324,624,0.519,15,49,0.306,309,575,0.537,0.531,57,77,0.74,44,149,193,351,83,21,109,79,720
150,Luguentz Dort\dortlu01,25,OKC,SF,71,71,2073,258,593,0.435,170,413,0.412,88,180,0.489,0.578,33,46,0.717,89,204,293,115,79,39,51,208,719
151,Jonathan Kuminga\kuminjo01,22,GSW,PF,47,10,1144,258,568,0.454,46,151,0.305,212,417,0.508,0.495,157,235,0.668,56,161,217,104,38,21,71,90,719
152,Dalton Knecht\knechda01,23,LAL,SF,78,16,1494,257,557,0.461,128,340,0.376,129,217,0.594,0.576,64,84,0.762,37,179,216,66,24,8,37,93,706
153,Corey Kispert\kispeco01,25,WAS,SF,61,0,1602,255,565,0.451,120,330,0.364,135,235,0.574,0.558,75,88,0.852,36,145,181,103,26,14,64,98,705
154,Daniel Gafford\gaffoda01,26,DAL,C,57,31,1226,283,403,0.702,0,0,,283,403,0.702,0.702,135,196,0.689,155,233,388,80,23,102,66,152,701
155,Jabari Smith Jr.\smithja05,21,HOU,PF,57,39,1716,248,566,0.438,98,277,0.354,150,289,0.519,0.525,104,126,0.825,105,294,399,60,25,41,61,123,698
156,Amir Coffey\coffeam01,27,LAC,SG,72,13,1748,240,510,0.471,101,247,0.409,139,263,0.529,0.57,115,129,0.891,32,129,161,77,40,7,45,120,696
157,Kyle Filipowski\filipky01,21,UTA,C,72,27,1522,260,518,0.502,77,220,0.35,183,298,0.614,0.576,93,143,0.65,112,328,440,140,48,22,102,171,690
158,Matas Buzelis\buzelma01,20,CHI,SF,80,31,1511,252,555,0.454,96,266,0.361,156,289,0.54,0.541,88,108,0.815,55,223,278,79,29,75,74,128,688
159,Tari Eason\easonta01,23,HOU,PF,57,16,1420,272,559,0.487,63,184,0.342,209,375,0.557,0.543,79,104,0.76,128,234,362,83,97,50,65,136,686
160,Jrue Holiday\holidjr01,34,BOS,PG,62,62,1896,254,573,0.443,108,306,0.353,146,267,0.547,0.538,70,77,0.909,76,189,265,239,66,27,77,101,686
161,Kevin Huerter\huertke01,26,2TM,SG,69,31,1679,257,604,0.425,132,391,0.338,125,213,0.587,0.535,35,49,0.714,30,175,205,156,66,23,67,121,681
161,Kevin Huerter\huertke01,26,SAC,SG,43,15,899,128,310,0.413,62,205,0.302,66,105,0.629,0.513,20,28,0.714,19,101,120,74,36,16,37,70,338
161,Kevin Huerter\huertke01,26,CHI,SG,26,16,780,129,294,0.439,70,186,0.376,59,108,0.546,0.558,15,21,0.714,11,74,85,82,30,7,30,51,343
162,Grayson Allen\allengr01,29,PHO,SG,64,7,1544,219,489,0.448,149,350,0.426,70,139,0.504,0.6,93,114,0.816,34,160,194,137,54,19,75,95,680
163,Jalen Johnson\johnsja05,23,ATL,SF,36,36,1284,271,542,0.5,44,141,0.312,227,401,0.566,0.541,94,126,0.746,62,297,359,181,56,36,106,67,680
164,Royce O'Neale\onealro01,31,PHO,SF,75,22,1837,241,570,0.423,179,441,0.406,62,129,0.481,0.58,19,26,0.731,53,296,349,163,67,34,65,151,680
165,Bobby Portis\portibo01,29,MIL,PF,49,7,1244,277,595,0.466,65,178,0.365,212,417,0.508,0.52,61,73,0.836,90,321,411,104,35,26,57,94,680
166,Terry Rozier\roziete01,30,MIA,PG,64,23,1658,248,635,0.391,91,308,0.295,157,327,0.48,0.462,92,108,0.852,44,194,238,167,37,14,78,73,679
167,Jerami Grant\grantje01,30,POR,PF,47,47,1524,214,574,0.373,108,296,0.365,106,278,0.381,0.467,141,166,0.849,26,137,163,101,41,46,65,109,677
168,Kentavious Caldwell-Pope\caldwke01,31,ORL,SG,77,77,2279,239,544,0.439,113,330,0.342,126,214,0.589,0.543,82,95,0.863,33,136,169,136,99,34,62,136,673
169,Mark Williams\willima07,23,CHO,C,44,41,1171,270,447,0.604,0,4,0.0,270,443,0.609,0.604,131,163,0.804,132,315,447,109,32,54,71,105,671
170,Ochai Agbaji\agbajoc01,24,TOR,SG,64,45,1739,266,534,0.498,101,253,0.399,165,281,0.587,0.593,34,48,0.708,61,181,242,98,58,30,54,125,667
171,Keon Ellis\elliske01,25,SAC,SG,80,28,1948,227,464,0.489,139,321,0.433,88,143,0.615,0.639,73,86,0.849,60,152,212,120,121,63,71,176,666
172,Paul George\georgpa01,34,PHI,PF,41,41,1334,245,570,0.43,96,268,0.358,149,302,0.493,0.514,79,97,0.814,24,195,219,178,75,20,106,101,665
173,Yves Missi\missiyv01,20,NOP,C,73,67,1956,269,492,0.547,0,1,0.0,269,491,0.548,0.547,127,204,0.623,255,346,601,99,37,98,82,145,665
174,Taurean Prince\princta02,30,MIL,SF,80,73,2166,235,514,0.457,147,335,0.439,88,179,0.492,0.6,39,48,0.813,34,253,287,155,76,15,82,165,656
175,Andrew Nembhard\nembhan01,25,IND,SG,65,65,1881,247,539,0.458,51,175,0.291,196,364,0.538,0.506,108,136,0.794,34,182,216,326,79,11,112,149,653
176,Walker Kessler\kesslwa01,23,UTA,C,58,58,1740,278,419,0.663,6,34,0.176,272,385,0.706,0.671,79,152,0.52,266,441,707,97,36,138,86,130,641
177,Isaiah Hartenstein\harteis01,26,OKC,C,57,53,1590,279,480,0.581,0,19,0.0,279,461,0.605,0.581,79,117,0.675,163,448,611,219,47,62,96,171,637
178,Ziaire Williams\willizi02,23,BRK,SF,63,45,1541,214,520,0.412,103,302,0.341,111,218,0.509,0.511,101,123,0.821,61,226,287,84,62,28,67,149,632
179,Cole Anthony\anthoco01,24,ORL,PG,67,22,1234,230,543,0.424,77,218,0.353,153,325,0.471,0.494,93,113,0.823,46,158,204,191,45,32,103,151,630
180,Wendell Carter Jr.\cartewe01,25,ORL,C,68,51,1758,226,491,0.46,37,158,0.234,189,333,0.568,0.498,129,175,0.737,151,341,492,134,52,41,77,199,618
181,Jeremy Sochan\sochaje01,21,SAS,PF,54,23,1364,251,469,0.535,28,91,0.308,223,378,0.59,0.565,87,125,0.696,127,225,352,128,45,27,84,131,617
182,Isaiah Collier\colliis01,20,UTA,PG,71,46,1839,234,555,0.422,42,169,0.249,192,386,0.497,0.459,105,154,0.682,32,203,235,446,66,16,208,149,615
183,Draymond Green\greendr01,34,GSW,PF,68,66,1983,216,509,0.424,80,246,0.325,136,263,0.517,0.503,101,147,0.687,74,340,414,383,99,70,174,219,613
184,Miles McBride\mcbrimi01,24,NYK,PG,64,10,1593,222,547,0.406,115,312,0.369,107,235,0.455,0.511,52,64,0.813,47,114,161,187,67,17,41,108,611
185,Zach Edey\edeyza01,22,MEM,C,66,55,1416,251,433,0.58,18,52,0.346,233,381,0.612,0.6,90,127,0.709,232,316,548,65,36,85,88,182,610
186,Sam Hauser\hausesa01,27,BOS,PF,71,19,1541,214,474,0.451,166,399,0.416,48,75,0.64,0.627,11,11,1.0,44,180,224,64,41,13,23,87,605
187,Jordan Hawkins\hawkijo01,22,NOP,SG,56,9,1321,207,556,0.372,110,332,0.331,97,224,0.433,0.471,80,98,0.816,25,133,158,66,30,23,58,51,604
188,Jordan Clarkson\clarkjo01,32,UTA,SG,37,9,962,201,493,0.408,84,232,0.362,117,261,0.448,0.493,114,143,0.797,25,93,118,138,31,9,86,52,600
189,Cam Thomas\thomaca02,23,BRK,SG,25,23,781,199,454,0.438,68,195,0.349,131,259,0.506,0.513,133,151,0.881,15,68,83,94,15,2,62,44,599
190,Kel'el Ware\wareke01,20,MIA,C,64,36,1422,257,464,0.554,35,111,0.315,222,353,0.629,0.592,46,67,0.687,116,357,473,60,39,71,57,111,595
191,Ausar Thompson\thompau01,22,DET,SF,59,48,1328,246,460,0.535,11,49,0.224,235,411,0.572,0.547,91,142,0.641,111,192,303,134,98,40,80,164,594
192,Nick Smith Jr.\smithni01,20,CHO,SG,60,27,1369,222,568,0.391,104,306,0.34,118,262,0.45,0.482,43,46,0.935,13,115,128,145,17,6,82,79,591
193,Kyshawn George\georgky01,21,WAS,SG,68,38,1802,203,546,0.372,114,354,0.322,89,192,0.464,0.476,70,93,0.753,49,236,285,169,68,50,97,201,590
194,Julian Strawther\strawju01,22,DEN,SG,65,4,1384,210,486,0.432,94,269,0.349,116,217,0.535,0.529,74,90,0.822,17,125,142,83,39,16,57,151,588
195,Davion Mitchell\mitchda01,26,2TM,PG,74,37,2027,223,476,0.468,84,211,0.398,139,265,0.525,0.557,58,84,0.69,35,132,167,363,72,16,128,185,588
195,Davion Mitchell\mitchda01,26,TOR,PG,44,22,1080,106,244,0.434,42,117,0.359,64,127,0.504,0.52,25,37,0.676,16,69,85,203,31,8,78,116,279
195,Davion Mitchell\mitchda01,26,MIA,PG,30,15,947,117,232,0.504,42,94,0.447,75,138,0.543,0.595,33,47,0.702,19,63,82,160,41,8,50,69,309
196,Bogdan Bogdanović\bogdabo01,32,2TM,SG,54,4,1348,210,492,0.427,105,289,0.363,105,203,0.517,0.534,58,66,0.879,24,135,159,146,41,11,74,127,583
196,Bogdan Bogdanović\bogdabo01,32,ATL,SG,24,0,598,83,224,0.371,44,146,0.301,39,78,0.5,0.469,30,34,0.882,12,54,66,49,20,6,37,57,240
196,Bogdan Bogdanović\bogdabo01,32,LAC,SG,30,4,750,127,268,0.474,61,143,0.427,66,125,0.528,0.588,28,32,0.875,12,81,93,97,21,5,37,70,343
197,Mike Conley\conlemi01,37,MIN,PG,71,64,1756,187,468,0.4,127,310,0.41,60,158,0.38,0.535,81,90,0.9,32,150,182,319,79,14,75,111,582
198,Jose Alvarado\alvarjo01,26,NOP,PG,56,23,1366,204,521,0.392,111,309,0.359,93,212,0.439,0.498,60,74,0.811,27,109,136,259,74,14,86,91,579
199,Deandre Ayton\aytonde01,26,POR,C,40,40,1206,265,468,0.566,6,32,0.188,259,436,0.594,0.573,40,60,0.667,124,282,406,64,31,39,69,88,576
200,Luke Kennard\kennalu01,28,MEM,SG,65,11,1472,206,431,0.478,113,261,0.433,93,170,0.547,0.609,51,57,0.895,37,146,183,215,50,5,72,59,576
201,Johnny Juzang\juzanjo01,23,UTA,SG,64,18,1270,204,475,0.429,118,314,0.376,86,161,0.534,0.554,45,53,0.849,42,142,184,68,39,8,36,126,571
202,Jaime Jaquez Jr.\jaqueja01,23,MIA,SF,66,17,1368,213,462,0.461,37,119,0.311,176,343,0.513,0.501,107,142,0.754,84,206,290,166,61,14,98,81,570
203,Brandon Miller\millebr02,22,CHO,SF,27,27,924,198,491,0.403,104,293,0.355,94,198,0.475,0.509,68,79,0.861,25,106,131,98,29,20,76,74,568
204,Cason Wallace\wallaca01,21,OKC,SG,68,43,1876,232,489,0.474,74,208,0.356,158,281,0.562,0.55,30,37,0.811,71,158,229,173,120,35,59,145,568
205,Jalen Suggs\suggsja01,23,ORL,PG,35,35,1002,197,481,0.41,76,242,0.314,121,239,0.506,0.489,97,110,0.882,23,118,141,129,51,33,102,98,567
206,Ayo Dosunmu\dosunay01,25,CHI,SG,46,26,1394,221,449,0.492,62,189,0.328,159,260,0.612,0.561,62,79,0.785,26,135,161,208,43,18,69,105,566
207,Patrick Williams\willipa01,23,CHI,PF,63,36,1576,205,516,0.397,96,272,0.353,109,244,0.447,0.49,60,83,0.723,43,194,237,124,48,32,86,88,566
208,Immanuel Quickley\quickim01,25,TOR,PG,33,33,918,184,438,0.42,85,225,0.378,99,213,0.465,0.517,111,128,0.867,16,101,117,191,23,4,58,61,564
209,Dalano Banton\bantoda01,25,POR,PG,67,7,1120,198,507,0.391,72,222,0.324,126,285,0.442,0.462,91,125,0.728,30,105,135,160,43,34,86,58,559
210,Peyton Watson\watsope01,22,DEN,SF,68,18,1656,204,428,0.477,48,136,0.353,156,292,0.534,0.533,95,137,0.693,47,186,233,94,48,93,56,123,551
211,Dorian Finney-Smith\finnedo01,31,2TM,PF,63,40,1818,195,435,0.448,129,314,0.411,66,121,0.545,0.597,30,45,0.667,80,167,247,90,58,23,56,136,549
211,Dorian Finney-Smith\finnedo01,31,BRK,PF,20,20,579,73,159,0.459,47,108,0.435,26,51,0.51,0.607,15,24,0.625,31,60,91,31,18,12,18,54,208
211,Dorian Finney-Smith\finnedo01,31,LAL,PF,43,20,1239,122,276,0.442,82,206,0.398,40,70,0.571,0.591,15,21,0.714,49,107,156,59,40,11,38,82,341
212,Justin Champagnie\champju01,23,WAS,SF,62,31,1340,210,411,0.511,74,193,0.383,136,218,0.624,0.601,50,73,0.685,112,239,351,60,65,39,54,110,544
213,Dejounte Murray\murrade01,28,NOP,PG,31,31,1012,194,494,0.393,52,174,0.299,142,320,0.444,0.445,102,124,0.823,17,183,200,228,63,12,106,61,542
214,A.J. Green\greenaj01,25,MIL,SG,73,7,1659,182,424,0.429,155,363,0.427,27,61,0.443,0.612,22,27,0.815,18,156,174,108,37,7,40,157,541
215,Aaron Nesmith\nesmiaa01,25,IND,SF,45,37,1123,192,379,0.507,84,195,0.431,108,184,0.587,0.617,73,80,0.913,37,141,178,54,35,17,37,114,541
216,Jared Butler\butleja02,24,2TM,SG,60,17,1044,203,453,0.448,60,169,0.355,143,284,0.504,0.514,75,91,0.824,25,85,110,220,42,13,80,97,541
216,Jared Butler\butleja02,24,WAS,PG,32,0,362,85,176,0.483,15,41,0.366,70,135,0.519,0.526,35,45,0.778,14,27,41,82,12,5,29,40,220
216,Jared Butler\butleja02,24,PHI,SG,28,17,682,118,277,0.426,45,128,0.352,73,149,0.49,0.507,40,46,0.87,11,58,69,138,30,8,51,57,321
217,Al Horford\horfoal01,38,BOS,C,60,42,1659,195,461,0.423,114,314,0.363,81,147,0.551,0.547,34,38,0.895,79,290,369,128,36,51,46,81,538
218,Brandon Clarke\clarkbr01,28,MEM,PF,64,18,1207,236,380,0.621,1,17,0.059,235,363,0.647,0.622,61,87,0.701,127,199,326,66,52,36,41,145,534
219,Tristan Da Silva\dasiltr01,23,ORL,SF,74,38,1629,199,483,0.412,80,239,0.335,119,244,0.488,0.495,55,63,0.873,73,172,245,113,33,18,56,94,533
220,Jamal Shead\sheadja01,22,TOR,PG,75,11,1467,204,504,0.405,72,223,0.323,132,281,0.47,0.476,53,69,0.768,30,85,115,316,58,10,117,158,533
221,Ricky Council IV\councri01,23,PHI,SF,73,12,1250,177,463,0.382,55,213,0.258,122,250,0.488,0.442,123,153,0.804,51,163,214,97,32,13,52,67,532
222,Nick Richards\richani01,27,2TM,C,57,43,1256,205,347,0.591,0,2,0.0,205,345,0.594,0.591,119,160,0.744,148,318,466,49,14,55,81,141,529
222,Nick Richards\richani01,27,CHO,C,21,9,440,64,114,0.561,0,1,0.0,64,113,0.566,0.561,59,87,0.678,51,107,158,28,7,26,33,48,187
222,Nick Richards\richani01,27,PHO,C,36,34,816,141,233,0.605,0,1,0.0,141,232,0.608,0.605,60,73,0.822,97,211,308,21,7,29,48,93,342
223,Jaden Ivey\iveyja01,22,DET,SG,30,30,898,190,413,0.46,63,154,0.409,127,259,0.49,0.536,85,116,0.733,40,84,124,119,28,11,89,67,528
224,Jalen Smith\smithja04,24,CHI,C,64,2,962,190,408,0.466,72,222,0.324,118,186,0.634,0.554,72,89,0.809,89,268,357,65,17,44,37,95,524
225,Tyrese Martin\martity01,25,BRK,SG,60,11,1315,189,465,0.406,99,282,0.351,90,183,0.492,0.513,46,58,0.793,58,161,219,122,34,9,74,77,523
226,Ron Holland\hollaro01,19,DET,SF,81,2,1266,197,416,0.474,36,151,0.238,161,265,0.608,0.517,92,122,0.754,40,178,218,82,49,17,72,141,522
227,Terance Mann\mannte01,28,2TM,SG,67,13,1414,205,413,0.496,60,163,0.368,145,250,0.58,0.569,47,68,0.691,68,131,199,121,47,15,47,128,517
227,Terance Mann\mannte01,28,LAC,SG,37,12,732,87,195,0.446,26,75,0.347,61,120,0.508,0.513,23,32,0.719,32,75,107,59,28,11,25,68,223
227,Terance Mann\mannte01,28,ATL,SG,30,1,682,118,218,0.541,34,88,0.386,84,130,0.646,0.619,24,36,0.667,36,56,92,62,19,4,22,60,294
228,Ryan Dunn\dunnry01,22,PHO,SF,74,44,1410,205,477,0.43,82,264,0.311,123,213,0.577,0.516,19,39,0.487,92,175,267,57,44,40,40,162,511
229,Sam Merrill\merrisa01,28,CLE,SG,71,4,1401,172,424,0.406,137,368,0.372,35,56,0.625,0.567,28,29,0.966,38,119,157,108,53,14,35,124,509
230,Josh Green\greenjo02,24,CHO,SG,68,67,1887,180,421,0.428,97,248,0.391,83,173,0.48,0.543,49,72,0.681,56,116,172,108,74,15,70,165,506
231,Goga Bitadze\bitadgo01,25,ORL,C,70,42,1430,207,339,0.611,3,28,0.107,204,311,0.656,0.615,85,133,0.639,167,296,463,137,49,98,72,150,502
232,Chris Boucher\bouchch01,32,TOR,PF,50,0,862,182,370,0.492,70,193,0.363,112,177,0.633,0.586,68,87,0.782,70,154,224,33,24,25,29,68,502
233,Cameron Payne\payneca01,30,NYK,PG,72,5,1090,179,446,0.401,93,256,0.363,86,190,0.453,0.506,49,54,0.907,14,90,104,203,39,16,52,111,500
234,Jaden Hardy\hardyja02,22,DAL,SG,57,3,907,180,414,0.435,76,197,0.386,104,217,0.479,0.527,60,86,0.698,9,80,89,81,28,5,82,90,496
235,Nikola Jović\jovicni01,21,MIA,PF,46,10,1156,172,377,0.456,78,210,0.371,94,167,0.563,0.56,72,87,0.828,26,154,180,131,38,13,60,82,494
236,Clint Capela\capelca01,30,ATL,C,55,41,1176,218,390,0.559,0,1,0.0,218,389,0.56,0.559,52,97,0.536,174,295,469,62,34,53,47,106,488
237,Chet Holmgren\holmgch01,22,OKC,C,32,32,877,167,341,0.49,44,116,0.379,123,225,0.547,0.554,101,134,0.754,48,209,257,63,23,71,56,72,479
238,Haywood Highsmith\highsha01,28,MIA,SF,74,42,1818,179,391,0.458,89,233,0.382,90,158,0.57,0.572,31,43,0.721,72,180,252,112,68,37,54,164,478
239,Cam Whitmore\whitmca01,20,HOU,SF,51,3,827,179,403,0.444,65,183,0.355,114,220,0.518,0.525,54,72,0.75,36,115,151,49,31,13,46,44,477
240,Kris Dunn\dunnkr01,30,LAC,PG,74,58,1783,192,437,0.439,75,224,0.335,117,213,0.549,0.525,15,22,0.682,53,198,251,210,128,27,74,197,474
241,Max Strus\strusma01,28,CLE,SF,50,37,1273,165,373,0.442,113,293,0.386,52,80,0.65,0.594,28,34,0.824,53,164,217,158,26,12,54,104,471
242,Jarace Walker\walkeja02,21,IND,PF,75,5,1187,170,360,0.472,75,185,0.405,95,175,0.543,0.576,46,69,0.667,25,204,229,110,54,25,78,115,461
243,Gabe Vincent\vincega01,28,LAL,PG,72,11,1527,168,420,0.4,109,309,0.353,59,111,0.532,0.53,15,21,0.714,20,72,92,98,51,13,41,152,460
244,Jake LaRavia\laravja01,23,2TM,PF,66,0,1349,160,337,0.475,60,142,0.423,100,195,0.513,0.564,78,115,0.678,90,169,259,158,62,23,86,132,458
244,Jake LaRavia\laravja01,23,MEM,PF,47,0,982,118,241,0.49,40,90,0.444,78,151,0.517,0.573,67,96,0.698,67,138,205,133,44,20,69,92,343
244,Jake LaRavia\laravja01,23,SAC,PF,19,0,367,42,96,0.438,20,52,0.385,22,44,0.5,0.542,11,19,0.579,23,31,54,25,18,3,17,40,115
245,Jusuf Nurkić\nurkiju01,30,2TM,C,51,32,1063,168,352,0.477,32,105,0.305,136,247,0.551,0.523,85,128,0.664,85,313,398,115,40,34,97,130,453
245,Jusuf Nurkić\nurkiju01,30,PHO,C,25,23,592,74,163,0.454,19,59,0.322,55,104,0.529,0.512,48,69,0.696,46,183,229,47,23,16,57,78,215
245,Jusuf Nurkić\nurkiju01,30,CHO,C,26,9,471,94,189,0.497,13,46,0.283,81,143,0.566,0.532,37,59,0.627,39,130,169,68,17,18,40,52,238
246,Joel Embiid\embiijo01,30,PHI,C,19,19,574,140,315,0.444,23,77,0.299,117,238,0.492,0.481,149,169,0.882,36,119,155,85,14,18,62,42,452
247,Trey Lyles\lylestr01,29,SAC,PF,69,5,1349,157,374,0.42,81,238,0.34,76,136,0.559,0.528,56,80,0.7,80,236,316,82,41,23,39,86,451
248,Trendon Watford\watfotr01,24,BRK,PF,44,6,913,164,350,0.469,29,88,0.33,135,262,0.515,0.51,93,122,0.762,37,123,160,115,27,12,83,95,450
249,Ja'Kobe Walter\walteja01,20,TOR,SG,52,18,1103,159,393,0.405,65,186,0.349,94,207,0.454,0.487,66,83,0.795,59,101,160,81,43,10,50,95,449
250,Brandon Boston Jr.\bostobr01,23,NOP,SG,42,10,993,166,381,0.436,49,140,0.35,117,241,0.485,0.5,67,85,0.788,28,106,134,92,53,9,52,73,448
251,Simone Fontecchio\fontesi01,29,DET,SF,75,0,1237,150,373,0.402,76,227,0.335,74,146,0.507,0.504,70,84,0.833,52,163,215,65,31,12,54,95,446
252,Justin Edwards\edwarju01,21,PHI,SF,44,26,1155,172,378,0.455,69,190,0.363,103,188,0.548,0.546,32,46,0.696,46,102,148,69,45,16,49,98,445
253,Seth Curry\curryse01,34,CHO,SG,68,14,1062,164,343,0.478,83,182,0.456,81,161,0.503,0.599,33,39,0.846,24,89,113,60,27,7,32,59,444
254,Luke Kornet\kornelu01,29,BOS,C,73,16,1361,187,280,0.668,0,3,0.0,187,277,0.675,0.668,67,97,0.691,190,198,388,117,36,71,31,119,441
255,Khris Middleton\middlkh01,33,2TM,SF,37,21,843,160,337,0.475,48,133,0.361,112,204,0.549,0.546,72,84,0.857,13,124,137,150,35,8,56,75,440
255,Khris Middleton\middlkh01,33,MIL,SF,23,7,534,108,211,0.512,35,86,0.407,73,125,0.584,0.595,39,46,0.848,5,80,85,102,17,5,37,52,290
255,Khris Middleton\middlkh01,33,WAS,SF,14,14,309,52,126,0.413,13,47,0.277,39,79,0.494,0.464,33,38,0.868,8,44,52,48,18,3,19,23,150
256,Jay Huff\huffja01,26,MEM,C,64,2,748,157,305,0.515,81,200,0.405,76,105,0.724,0.648,44,56,0.786,30,99,129,38,16,56,34,78,439
257,Donovan Clingan\clingdo01,20,POR,C,67,37,1324,180,334,0.539,14,49,0.286,166,285,0.582,0.56,62,104,0.596,217,310,527,77,34,110,72,189,436
258,Kenrich Williams\willike04,30,OKC,PF,69,7,1132,171,354,0.483,66,171,0.386,105,183,0.574,0.576,28,39,0.718,65,176,241,97,43,10,39,110,436
259,Isaiah Stewart\stewais01,23,DET,C,72,4,1434,176,315,0.559,17,53,0.321,159,262,0.607,0.586,66,87,0.759,130,269,399,123,28,101,68,183,435
260,Thomas Bryant\bryanth01,27,2TM,C,66,8,963,163,321,0.508,48,148,0.324,115,173,0.665,0.583,55,64,0.859,83,168,251,53,28,41,30,76,429
260,Thomas Bryant\bryanth01,27,MIA,C,10,0,115,12,28,0.429,6,17,0.353,6,11,0.545,0.536,11,11,1.0,6,26,32,4,1,9,2,9,41
260,Thomas Bryant\bryanth01,27,IND,C,56,8,848,151,293,0.515,42,131,0.321,109,162,0.673,0.587,44,53,0.83,77,142,219,49,27,32,28,67,388
261,Noah Clowney\clownno01,20,BRK,PF,46,20,1042,133,372,0.358,87,261,0.333,46,111,0.414,0.474,67,80,0.838,43,138,181,40,24,21,46,105,420
262,Jamison Battle\battlja01,23,TOR,SF,59,10,1042,149,347,0.429,105,259,0.405,44,88,0.5,0.581,16,18,0.889,37,121,158,53,17,10,27,92,419
263,Jeremiah Robinson-Earl\robinje02,24,NOP,PF,66,9,1239,158,347,0.455,56,164,0.341,102,183,0.557,0.536,46,55,0.836,110,205,315,88,39,7,51,79,418
264,Vit Krejci\krejcvi01,24,ATL,PG,57,16,1153,145,292,0.497,90,206,0.437,55,86,0.64,0.651,32,45,0.711,22,134,156,147,36,26,50,105,412
265,Trayce Jackson-Davis\jackstr02,24,GSW,C,62,37,967,174,302,0.576,0,3,0.0,174,299,0.582,0.576,59,102,0.578,122,189,311,104,23,38,45,73,407
266,Zach Collins\colliza01,27,2TM,PF,64,12,977,153,302,0.507,32,106,0.302,121,196,0.617,0.56,69,78,0.885,102,186,288,111,29,29,60,132,407
266,Zach Collins\colliza01,27,SAS,C,36,4,425,61,132,0.462,14,46,0.304,47,86,0.547,0.515,31,35,0.886,38,63,101,52,14,15,23,70,167
266,Zach Collins\colliza01,27,CHI,PF,28,8,552,92,170,0.541,18,60,0.3,74,110,0.673,0.594,38,43,0.884,64,123,187,59,15,14,37,62,240
267,Moussa Diabaté\diabamo01,23,CHO,C,71,8,1241,167,280,0.596,0,6,0.0,167,274,0.609,0.596,69,116,0.595,187,251,438,56,46,40,61,109,403
268,Brandon Ingram\ingrabr01,27,NOP,SF,18,18,595,155,333,0.465,43,115,0.374,112,218,0.514,0.53,47,55,0.855,17,83,100,93,16,11,69,45,400
269,Gary Payton II\paytoga02,32,GSW,SG,62,11,927,171,298,0.574,31,95,0.326,140,203,0.69,0.626,27,38,0.711,53,132,185,83,52,17,39,108,400
270,Day'Ron Sharpe\sharpda01,23,BRK,C,50,2,907,165,317,0.521,11,45,0.244,154,272,0.566,0.538,56,74,0.757,149,181,330,91,41,42,63,113,397
271,Jonathan Mogbo\mogbojo01,23,TOR,PF,63,18,1286,156,356,0.438,17,70,0.243,139,286,0.486,0.462,60,82,0.732,109,202,311,146,55,34,70,136,389
272,Moritz Wagner\wagnemo01,27,ORL,C,30,1,564,140,249,0.562,27,75,0.36,113,174,0.649,0.616,79,110,0.718,40,108,148,42,24,12,49,55,386
273,Sandro Mamukelashvili\mamuksa01,25,SAS,PF,61,0,681,141,281,0.502,60,161,0.373,81,120,0.675,0.609,43,58,0.741,62,125,187,48,22,17,26,60,385
274,Kelly Olynyk\olynyke01,33,2TM,C,44,22,891,134,268,0.5,33,79,0.418,101,189,0.534,0.562,83,108,0.769,62,144,206,128,33,19,76,123,384
274,Kelly Olynyk\olynyke01,33,TOR,C,24,2,383,59,118,0.5,19,43,0.442,40,75,0.533,0.581,34,43,0.791,25,64,89,56,16,8,35,59,171
274,Kelly Olynyk\olynyke01,33,NOP,C,20,20,508,75,150,0.5,14,36,0.389,61,114,0.535,0.547,49,65,0.754,37,80,117,72,17,11,41,64,213
275,Jaxson Hayes\hayesja02,24,LAL,C,56,35,1093,161,223,0.722,0,3,0.0,161,220,0.732,0.722,61,98,0.622,78,191,269,58,31,51,43,136,383
276,Alex Caruso\carusal01,30,OKC,SG,54,3,1041,140,314,0.446,60,170,0.353,80,144,0.556,0.541,42,51,0.824,38,121,159,137,87,30,37,102,382
277,Jonathan Isaac\isaacjo01,27,ORL,PF,71,1,1090,134,324,0.414,39,151,0.258,95,173,0.549,0.474,73,107,0.682,120,194,314,40,61,80,33,90,380
278,Precious Achiuwa\achiupr01,25,NYK,C,57,10,1170,164,327,0.502,10,36,0.278,154,291,0.529,0.517,41,69,0.594,101,216,317,55,47,42,45,81,379
279,Talen Horton-Tucker\hortota01,24,CHI,SG,58,0,724,133,291,0.457,41,122,0.336,92,169,0.544,0.527,72,98,0.735,19,81,100,83,21,11,40,59,379
280,Marcus Sasser\sassema01,24,DET,PG,57,1,811,137,296,0.463,58,152,0.382,79,144,0.549,0.561,43,51,0.843,18,51,69,133,37,4,54,72,375
281,Julian Phillips\phillju01,21,CHI,SF,79,5,1123,128,287,0.446,50,153,0.327,78,134,0.582,0.533,60,76,0.789,67,102,169,39,38,20,27,108,366
282,Cody Martin\martico01,29,2TM,SF,53,8,1173,136,325,0.418,43,151,0.285,93,174,0.534,0.485,43,61,0.705,53,171,224,105,56,32,51,95,358
282,Cody Martin\martico01,29,CHO,SF,39,8,967,116,268,0.433,40,124,0.323,76,144,0.528,0.507,34,49,0.694,40,136,176,89,43,26,42,72,306
282,Cody Martin\martico01,29,PHO,SF,14,0,206,20,57,0.351,3,27,0.111,17,30,0.567,0.377,9,12,0.75,13,35,48,16,13,6,9,23,52
283,Kyle Anderson\anderky01,31,2TM,PF,61,4,1002,142,303,0.469,25,70,0.357,117,233,0.502,0.51,48,65,0.738,53,153,206,145,40,33,37,81,357
283,Kyle Anderson\anderky01,31,GSW,PF,36,3,541,76,169,0.45,19,52,0.365,57,117,0.487,0.506,18,27,0.667,27,83,110,81,26,20,20,40,189
283,Kyle Anderson\anderky01,31,MIA,SF,25,1,461,66,134,0.493,6,18,0.333,60,116,0.517,0.515,30,38,0.789,26,70,96,64,14,13,17,41,168
284,Alec Burks\burksal01,33,MIA,SG,49,14,863,115,271,0.424,88,207,0.425,27,64,0.422,0.587,38,49,0.776,15,109,124,55,28,7,29,37,356
285,Caleb Martin\martica02,29,2TM,SF,45,24,1218,129,304,0.424,37,103,0.359,92,201,0.458,0.485,61,98,0.622,53,124,177,95,46,23,56,87,356
285,Caleb Martin\martica02,29,PHI,SF,31,24,943,101,232,0.435,33,87,0.379,68,145,0.469,0.506,46,74,0.622,43,93,136,69,34,20,43,63,281
285,Caleb Martin\martica02,29,DAL,SF,14,0,275,28,72,0.389,4,16,0.25,24,56,0.429,0.417,15,24,0.625,10,31,41,26,12,3,13,24,75
286,Garrison Mathews\mathega01,28,ATL,SG,47,2,830,102,257,0.397,85,218,0.39,17,39,0.436,0.562,64,78,0.821,13,74,87,60,26,15,31,81,353
287,Tidjane Salaün\salauti01,19,CHO,PF,60,10,1244,114,345,0.33,58,205,0.283,56,140,0.4,0.414,67,94,0.713,70,210,280,74,29,14,58,84,353
288,Jared McCain\mccaija01,20,PHI,SG,23,8,592,126,274,0.46,51,133,0.383,75,141,0.532,0.553,49,56,0.875,13,43,56,60,15,0,37,37,352
289,Ryan Rollins\rolliry01,22,MIL,PG,56,19,820,132,271,0.487,49,120,0.408,83,151,0.55,0.577,36,45,0.8,21,87,108,104,42,17,53,88,349
290,Javonte Green\greenja02,31,2TM,SG,68,19,1258,123,287,0.429,46,141,0.326,77,146,0.527,0.509,55,76,0.724,59,159,218,56,65,31,32,98,347
290,Javonte Green\greenja02,31,NOP,SG,50,18,1092,100,224,0.446,38,108,0.352,62,116,0.534,0.531,50,66,0.758,49,129,178,45,55,30,28,77,288
290,Javonte Green\greenja02,31,CLE,SG,18,1,166,23,63,0.365,8,33,0.242,15,30,0.5,0.429,5,10,0.5,10,30,40,11,10,1,4,21,59
291,Kevon Looney\looneke01,28,GSW,C,76,6,1142,143,278,0.514,2,5,0.4,141,273,0.516,0.518,56,99,0.566,185,277,462,118,46,37,39,154,344
292,Aaron Holiday\holidaa01,28,HOU,PG,62,3,792,117,268,0.437,72,181,0.398,45,87,0.517,0.571,34,41,0.829,13,65,78,83,19,11,37,64,340
293,Quinten Post\postqu01,24,GSW,PF,42,14,686,123,274,0.449,73,179,0.408,50,95,0.526,0.582,21,27,0.778,35,113,148,56,16,18,33,83,340
294,Bruce Brown\brownbr01,28,2TM,PG,41,12,922,130,309,0.421,27,81,0.333,103,228,0.452,0.464,53,65,0.815,40,124,164,84,34,10,39,71,340
294,Bruce Brown\brownbr01,28,TOR,PG,18,0,353,57,131,0.435,11,36,0.306,46,95,0.484,0.477,26,29,0.897,17,51,68,28,17,3,19,26,151
294,Bruce Brown\brownbr01,28,NOP,PG,23,12,569,73,178,0.41,16,45,0.356,57,133,0.429,0.455,27,36,0.75,23,73,96,56,17,7,20,45,189
295,Adem Bona\bonaad01,21,PHI,C,58,11,905,135,192,0.703,0,1,0.0,135,191,0.707,0.703,67,100,0.67,92,153,245,27,26,69,61,125,337
296,Isaac Okoro\okorois01,24,CLE,SG,55,22,1053,124,267,0.464,56,151,0.371,68,116,0.586,0.569,33,46,0.717,49,81,130,68,32,16,23,104,337
297,Svi Mykhailiuk\mykhasv01,27,UTA,SF,38,13,760,118,302,0.391,70,203,0.345,48,99,0.485,0.507,28,35,0.8,22,68,90,76,19,7,52,43,334
298,Mason Plumlee\plumlma01,34,PHO,C,74,21,1300,125,202,0.619,0,4,0.0,125,198,0.631,0.619,83,128,0.648,116,339,455,134,33,47,59,154,333
299,Ben Sheppard\sheppbe01,23,IND,SG,63,9,1228,120,287,0.418,68,199,0.342,52,88,0.591,0.537,24,27,0.889,44,133,177,85,38,14,22,125,332
300,Tristan Vukcevic\vukcetr01,21,WAS,C,35,1,513,120,242,0.496,38,102,0.373,82,140,0.586,0.574,52,67,0.776,26,104,130,39,11,23,42,57,330
301,Tre Jones\jonestr01,25,2TM,PG,46,9,905,128,238,0.538,19,48,0.396,109,190,0.574,0.578,55,67,0.821,31,85,116,192,37,10,35,55,330
301,Tre Jones\jonestr01,25,SAS,PG,28,0,450,45,93,0.484,8,26,0.308,37,67,0.552,0.527,25,33,0.758,15,43,58,104,18,5,21,33,123
301,Tre Jones\jonestr01,25,CHI,PG,18,9,455,83,145,0.572,11,22,0.5,72,123,0.585,0.61,30,34,0.882,16,42,58,88,19,5,14,22,207
302,Dalen Terry\terryda01,22,CHI,SG,73,5,987,120,268,0.448,37,104,0.356,83,164,0.506,0.517,49,69,0.71,38,86,124,97,44,15,53,114,326
303,Karlo Matković\matkoka01,23,NOP,PF,42,7,791,135,235,0.574,21,66,0.318,114,169,0.675,0.619,34,44,0.773,64,145,209,46,22,41,43,106,325
304,Dean Wade\wadede01,28,CLE,PF,59,30,1252,112,271,0.413,80,222,0.36,32,49,0.653,0.561,16,30,0.533,51,198,249,76,42,20,22,101,320
305,DaQuan Jeffries\jeffrda01,27,CHO,SG,47,20,1071,118,291,0.405,55,164,0.335,63,127,0.496,0.5,24,30,0.8,37,98,135,53,26,25,35,99,315
306,Shake Milton\miltosh01,28,2TM,SG,57,2,837,115,254,0.453,38,106,0.358,77,148,0.52,0.528,47,59,0.797,31,73,104,102,25,4,40,67,315
306,Shake Milton\miltosh01,28,BRK,SG,27,1,492,73,157,0.465,28,72,0.389,45,85,0.529,0.554,25,33,0.758,16,35,51,64,15,1,20,43,199
306,Shake Milton\miltosh01,28,LAL,SG,30,1,345,42,97,0.433,10,34,0.294,32,63,0.508,0.485,22,26,0.846,15,38,53,38,10,3,20,24,116
307,Dereck Lively II\livelde01,20,DAL,C,36,29,833,134,191,0.702,0,0,,134,191,0.702,0.702,46,73,0.63,104,166,270,85,20,56,41,100,314
308,Nicolas Batum\batumni01,36,LAC,PF,78,8,1367,104,238,0.437,88,203,0.433,16,35,0.457,0.622,17,21,0.81,47,171,218,84,52,36,34,111,313
309,Jabari Walker\walkeja01,22,POR,SF,60,1,749,118,229,0.515,28,72,0.389,90,157,0.573,0.576,49,71,0.69,59,152,211,37,33,6,34,87,313
310,Neemias Queta\quetane01,25,BOS,C,62,6,863,132,203,0.65,0,3,0.0,132,200,0.66,0.65,46,61,0.754,89,147,236,45,18,42,40,106,310
311,Malcolm Brogdon\brogdma01,32,WAS,PG,24,13,564,104,240,0.433,16,56,0.286,88,184,0.478,0.467,81,92,0.88,21,70,91,98,13,5,38,30,305
312,Antonio Reeves\reevean01,24,NOP,SG,44,6,660,113,248,0.456,51,129,0.395,62,119,0.521,0.558,28,35,0.8,18,45,63,39,21,4,30,40,305
313,Marcus Smart\smartma01,30,2TM,PG,34,7,680,101,257,0.393,49,141,0.348,52,116,0.448,0.488,54,71,0.761,18,54,72,109,39,9,54,53,305
313,Marcus Smart\smartma01,30,MEM,PG,19,6,400,53,148,0.358,29,90,0.322,24,58,0.414,0.456,30,36,0.833,14,29,43,71,23,6,35,31,165
313,Marcus Smart\smartma01,30,WAS,PG,15,1,280,48,109,0.44,20,51,0.392,28,58,0.483,0.532,24,35,0.686,4,25,29,38,16,3,19,22,140
314,Orlando Robinson\robinor01,24,2TM,C,44,8,770,116,261,0.444,17,52,0.327,99,209,0.474,0.477,54,70,0.771,89,131,220,77,17,16,49,100,303
314,Orlando Robinson\robinor01,24,SAC,C,9,0,57,7,17,0.412,1,5,0.2,6,12,0.5,0.441,4,7,0.571,3,11,14,9,3,1,4,6,19
314,Orlando Robinson\robinor01,24,TOR,C,35,8,713,109,244,0.447,16,47,0.34,93,197,0.472,0.48,50,63,0.794,86,120,206,68,14,15,45,94,284
315,Andre Drummond\drumman01,31,PHI,C,40,23,751,117,234,0.5,3,20,0.15,114,214,0.533,0.506,56,90,0.622,109,201,310,34,39,18,55,94,293
316,Kris Murray\murrakr01,24,POR,SF,69,6,1040,117,279,0.419,27,120,0.225,90,159,0.566,0.468,26,57,0.456,76,106,182,68,35,17,43,66,287
317,Landry Shamet\shamela01,27,NYK,SG,50,0,762,106,230,0.461,62,156,0.397,44,74,0.595,0.596,12,18,0.667,11,50,61,27,23,2,22,52,286
318,Jeff Dowtin\dowtije01,27,PHI,PG,41,3,621,112,230,0.487,28,70,0.4,84,160,0.525,0.548,33,45,0.733,12,48,60,78,24,12,15,29,285
319,Josh Okogie\okogijo01,26,2TM,SG,40,7,625,94,212,0.443,32,92,0.348,62,120,0.517,0.519,63,85,0.741,45,68,113,33,48,18,31,47,283
319,Josh Okogie\okogijo01,26,PHO,SG,25,1,351,56,114,0.491,16,42,0.381,40,72,0.556,0.561,22,32,0.688,32,40,72,14,21,10,16,28,150
319,Josh Okogie\okogijo01,26,CHO,SG,15,6,274,38,98,0.388,16,50,0.32,22,48,0.458,0.469,41,53,0.774,13,28,41,19,27,8,15,19,133
320,KJ Simpson\simpskj01,22,CHO,PG,36,15,842,104,301,0.346,33,130,0.254,71,171,0.415,0.4,41,50,0.82,39,70,109,112,34,6,56,56,282
321,Drew Eubanks\eubandr01,27,2TM,C,61,4,746,115,194,0.593,3,6,0.5,112,188,0.596,0.601,47,71,0.662,60,166,226,54,12,39,41,63,280
321,Drew Eubanks\eubandr01,27,UTA,C,37,4,568,88,145,0.607,3,5,0.6,85,140,0.607,0.617,36,57,0.632,40,128,168,45,10,32,31,46,215
321,Drew Eubanks\eubandr01,27,LAC,C,24,0,178,27,49,0.551,0,1,0.0,27,48,0.563,0.551,11,14,0.786,20,38,58,9,2,7,10,17,65
322,Jaylin Williams\willija07,22,OKC,PF,47,9,784,97,221,0.439,61,153,0.399,36,68,0.529,0.577,23,30,0.767,48,214,262,120,22,29,35,79,278
323,Brandon Williams\willibr03,25,DAL,PG,33,3,487,98,188,0.521,24,60,0.4,74,128,0.578,0.585,55,66,0.833,12,46,58,76,24,5,39,33,275
324,KJ Martin\martike04,24,2TM,PF,43,16,912,111,201,0.552,15,58,0.259,96,143,0.671,0.59,37,47,0.787,30,95,125,48,17,22,24,101,274
324,KJ Martin\martike04,24,PHI,PF,24,7,480,61,99,0.616,8,21,0.381,53,78,0.679,0.657,24,29,0.828,21,51,72,19,11,16,12,62,154
324,KJ Martin\martike04,24,UTA,SF,19,9,432,50,102,0.49,7,37,0.189,43,65,0.662,0.525,13,18,0.722,9,44,53,29,6,6,12,39,120
325,Vasilije Micić\micicva01,31,2TM,PG,41,16,785,95,273,0.348,45,125,0.36,50,148,0.338,0.43,34,41,0.829,20,69,89,128,15,0,77,45,269
325,Vasilije Micić\micicva01,31,CHO,PG,36,16,764,95,273,0.348,45,125,0.36,50,148,0.338,0.43,34,41,0.829,20,67,87,127,15,0,74,44,269
325,Vasilije Micić\micicva01,31,PHO,PG,5,0,21,0,0,,0,0,,0,0,,,0,0,,0,2,2,1,0,0,3,1,0
326,Lonzo Ball\balllo01,27,CHI,PG,35,14,777,89,243,0.366,67,195,0.344,22,48,0.458,0.504,22,27,0.815,25,93,118,115,47,17,41,55,267
327,Tosan Evbuomwan\evbuoto01,23,BRK,SF,28,0,665,94,220,0.427,24,77,0.312,70,143,0.49,0.482,55,73,0.753,32,88,120,55,24,10,39,55,267
328,Jett Howard\howarje01,21,ORL,SF,60,0,701,98,262,0.374,55,186,0.296,43,76,0.566,0.479,16,23,0.696,20,50,70,44,13,11,36,68,267
329,Eric Gordon\gordoer01,36,PHI,SG,39,13,768,87,204,0.426,56,137,0.409,31,67,0.463,0.564,36,48,0.75,8,38,46,65,26,12,28,32,266
330,Lindy Waters III\waterli01,27,2TM,SG,52,9,778,92,249,0.369,64,186,0.344,28,63,0.444,0.498,8,11,0.727,20,90,110,52,27,11,20,62,256
330,Lindy Waters III\waterli01,27,GSW,SG,38,9,655,76,205,0.371,49,148,0.331,27,57,0.474,0.49,8,11,0.727,16,80,96,42,22,10,17,55,209
330,Lindy Waters III\waterli01,27,DET,SG,14,0,123,16,44,0.364,15,38,0.395,1,6,0.167,0.534,0,0,,4,10,14,10,5,1,3,7,47
331,Ben Simmons\simmobe01,28,2TM,PG,51,24,1120,116,223,0.52,0,0,,116,223,0.52,0.52,24,33,0.727,47,194,241,285,38,23,102,107,256
331,Ben Simmons\simmobe01,28,BRK,PG,33,24,825,93,170,0.547,0,0,,93,170,0.547,0.547,18,26,0.692,30,142,172,229,26,16,88,81,204
331,Ben Simmons\simmobe01,28,LAC,PG,18,0,295,23,53,0.434,0,0,,23,53,0.434,0.434,6,7,0.857,17,52,69,56,12,7,14,26,52
332,Oso Ighodaro\ighodos01,22,PHO,PF,61,6,1045,113,187,0.604,0,2,0.0,113,185,0.611,0.604,29,50,0.58,66,156,222,71,28,29,39,102,255
333,Pelle Larsson\larsspe01,23,MIA,SG,55,8,782,89,203,0.438,32,95,0.337,57,108,0.528,0.517,41,61,0.672,28,64,92,65,32,7,24,91,251
334,Lonnie Walker IV\walkelo01,26,PHI,SG,20,7,477,89,212,0.42,45,127,0.354,44,85,0.518,0.526,24,30,0.8,6,57,63,50,10,5,25,27,247
335,Bol Bol\bolbo01,25,PHO,PF,36,10,448,96,183,0.525,32,93,0.344,64,90,0.711,0.612,20,26,0.769,20,84,104,22,9,25,20,20,244
336,Caleb Houstan\houstca01,22,ORL,SF,58,6,788,80,190,0.421,64,160,0.4,16,30,0.533,0.589,15,17,0.882,19,56,75,35,22,6,13,62,239
337,A.J. Lawson\lawsoaj01,24,TOR,SG,26,2,486,80,190,0.421,33,101,0.327,47,89,0.528,0.508,43,63,0.683,20,66,86,31,13,6,15,44,236
338,Malaki Branham\branhma01,21,SAS,SG,47,0,427,87,190,0.458,34,84,0.405,53,106,0.5,0.547,27,33,0.818,7,44,51,38,11,2,34,29,235
339,Ajay Mitchell\mitchaj01,22,OKC,SG,36,1,597,91,184,0.495,23,60,0.383,68,124,0.548,0.557,29,35,0.829,18,50,68,64,25,4,29,68,234
340,Monte Morris\morrimo01,29,PHO,PG,45,0,571,83,195,0.426,31,86,0.36,52,109,0.477,0.505,36,42,0.857,12,55,67,73,20,3,21,23,233
341,Richaun Holmes\holmeri01,31,WAS,PF,31,7,534,90,139,0.647,0,3,0.0,90,136,0.662,0.647,50,60,0.833,62,115,177,42,9,23,21,49,230
342,Andre Jackson Jr.\jacksan01,23,MIL,SG,67,43,980,94,197,0.477,30,76,0.395,64,121,0.529,0.553,12,24,0.5,65,117,182,83,34,14,58,114,230
343,Cody Williams\willico04,20,UTA,SG,50,21,1060,83,257,0.323,35,135,0.259,48,122,0.393,0.391,29,40,0.725,27,86,113,59,23,16,44,95,230
344,Reed Sheppard\sheppre01,20,HOU,PG,52,3,654,84,239,0.351,48,142,0.338,36,97,0.371,0.452,13,16,0.813,16,62,78,75,35,17,37,53,229
345,Gui Santos\santogu01,22,GSW,PF,56,2,762,82,179,0.458,34,103,0.33,48,76,0.632,0.553,29,42,0.69,72,100,172,80,25,10,42,91,227
346,Steven Adams\adamsst01,31,HOU,C,58,3,794,91,167,0.545,0,2,0.0,91,165,0.552,0.545,43,93,0.462,166,161,327,66,22,28,54,60,225
347,AJ Johnson\johnsaj01,20,2TM,SG,29,11,639,82,213,0.385,24,90,0.267,58,123,0.472,0.441,32,37,0.865,8,51,59,76,12,3,35,50,220
347,AJ Johnson\johnsaj01,20,MIL,SG,7,0,44,8,19,0.421,3,5,0.6,5,14,0.357,0.5,1,2,0.5,0,7,7,7,1,0,4,0,20
347,AJ Johnson\johnsaj01,20,WAS,SG,22,11,595,74,194,0.381,21,85,0.247,53,109,0.486,0.436,31,35,0.886,8,44,52,69,11,3,31,50,200
348,Rob Dillingham\dilliro01,20,MIN,PG,49,1,516,93,211,0.441,25,74,0.338,68,137,0.496,0.5,8,15,0.533,12,38,50,98,20,1,53,37,219
349,Blake Wesley\weslebl01,21,SAS,SG,58,0,683,81,186,0.435,17,58,0.293,64,128,0.5,0.481,38,61,0.623,17,44,61,114,37,6,54,46,217
350,Pat Connaughton\connapa01,32,MIL,SG,41,1,603,83,177,0.469,26,81,0.321,57,96,0.594,0.542,24,31,0.774,19,90,109,70,9,11,24,45,216
351,GG Jackson II\jacksgg01,20,MEM,PF,29,3,459,74,199,0.372,32,95,0.337,42,104,0.404,0.452,29,40,0.725,27,65,92,29,12,5,31,30,209
352,DeAndre Jordan\jordade01,36,DEN,C,56,5,691,91,140,0.65,0,0,,91,140,0.65,0.65,27,64,0.422,84,200,284,53,16,27,40,74,209
353,Herbert Jones\joneshe01,26,NOP,SF,20,20,648,75,172,0.436,22,72,0.306,53,100,0.53,0.5,33,40,0.825,22,56,78,65,37,9,35,66,205
354,Larry Nance Jr.\nancela02,32,ATL,PF,24,3,463,80,155,0.516,34,76,0.447,46,79,0.582,0.626,9,13,0.692,23,80,103,38,20,13,16,37,203
355,Olivier-Maxence Prosper\prospol01,22,DAL,PF,52,4,584,70,174,0.402,12,51,0.235,58,123,0.472,0.437,49,76,0.645,44,82,126,40,26,6,14,28,201
356,Jock Landale\landajo01,29,HOU,C,42,3,500,81,152,0.533,11,26,0.423,70,126,0.556,0.569,27,40,0.675,56,81,137,37,13,10,21,49,200
357,Jalen Pickett\pickeja02,25,DEN,SG,49,4,666,77,180,0.428,40,101,0.396,37,79,0.468,0.539,6,8,0.75,15,56,71,107,19,5,24,38,200
358,Kai Jones\joneska01,24,2TM,C,40,6,468,87,109,0.798,1,5,0.2,86,104,0.827,0.803,23,32,0.719,40,85,125,25,15,23,18,50,198
358,Kai Jones\joneska01,24,LAC,C,28,0,208,26,36,0.722,0,2,0.0,26,34,0.765,0.722,9,12,0.75,15,31,46,10,6,13,10,23,61
358,Kai Jones\joneska01,24,DAL,C,12,6,260,61,73,0.836,1,3,0.333,60,70,0.857,0.842,14,20,0.7,25,54,79,15,9,10,8,27,137
359,Mouhamed Gueye\gueyemo02,22,ATL,PF,33,28,533,72,171,0.421,21,81,0.259,51,90,0.567,0.482,32,42,0.762,44,95,139,27,28,33,15,55,197
360,Jamal Cain\cainja01,25,NOP,SF,37,0,502,68,158,0.43,26,80,0.325,42,78,0.538,0.513,34,50,0.68,27,58,85,22,23,9,22,46,196
361,Collin Gillespie\gilleco01,25,PHO,PG,33,9,461,68,158,0.43,39,90,0.433,29,68,0.426,0.554,19,22,0.864,22,56,78,78,21,5,17,30,194
362,Duop Reath\reathdu01,28,POR,C,46,0,469,70,166,0.422,34,106,0.321,36,60,0.6,0.524,20,22,0.909,44,48,92,26,12,14,16,41,194
363,Craig Porter Jr.\portecr01,24,CLE,PG,51,1,513,72,140,0.514,21,48,0.438,51,92,0.554,0.589,23,32,0.719,19,48,67,71,17,15,38,25,188
364,Jae'Sean Tate\tateja01,29,HOU,SF,52,2,588,70,148,0.473,16,46,0.348,54,102,0.529,0.527,32,47,0.681,50,67,117,47,26,7,22,82,188
365,Zeke Nnaji\nnajize01,24,DEN,PF,57,4,608,70,141,0.496,17,52,0.327,53,89,0.596,0.557,27,44,0.614,33,57,90,23,25,38,14,62,184
366,Paul Reed\reedpa01,25,DET,C,45,0,438,72,142,0.507,8,28,0.286,64,114,0.561,0.535,32,42,0.762,40,83,123,44,39,25,26,75,184
367,Tre Mann\manntr01,23,CHO,PG,13,0,319,70,161,0.435,24,60,0.4,46,101,0.455,0.509,19,21,0.905,12,26,38,39,7,4,25,24,183
368,Vince Williams Jr.\willivi01,24,MEM,SG,27,5,499,67,167,0.401,26,95,0.274,41,72,0.569,0.479,19,24,0.792,22,76,98,55,12,7,33,45,179
369,Cory Joseph\josepco01,33,ORL,PG,50,16,612,62,154,0.403,39,107,0.364,23,47,0.489,0.529,14,18,0.778,17,57,74,72,26,4,18,50,177
370,Dante Exum\exumda01,29,DAL,PG,20,13,372,64,134,0.478,23,53,0.434,41,81,0.506,0.563,23,31,0.742,4,29,33,56,12,3,22,34,174
371,Jeff Green\greenje02,38,HOU,PF,32,3,396,61,121,0.504,29,79,0.367,32,42,0.762,0.624,21,26,0.808,11,47,58,20,6,4,9,32,172
372,Kessler Edwards\edwarke02,24,DAL,SF,40,18,608,67,135,0.496,22,54,0.407,45,81,0.556,0.578,12,13,0.923,22,93,115,42,19,20,16,62,168
373,Keaton Wallace\wallake01,25,ATL,PG,31,5,501,65,162,0.401,27,82,0.329,38,80,0.475,0.485,11,11,1.0,7,43,50,81,28,9,33,39,168
374,Jaylon Tyson\tysonja01,22,CLE,SG,47,3,453,64,149,0.43,20,58,0.345,44,91,0.484,0.497,19,24,0.792,37,59,96,44,13,3,26,50,167
375,Grant Williams\willigr01,26,CHO,PF,16,7,479,54,123,0.439,27,74,0.365,27,49,0.551,0.549,31,37,0.838,18,64,82,37,18,13,28,46,166
376,Jaylen Clark\clarkja02,23,MIN,SG,40,4,522,56,120,0.467,22,51,0.431,34,69,0.493,0.558,29,37,0.784,26,27,53,26,36,2,8,61,163
377,Quenton Jackson\jacksqu01,26,IND,PG,28,7,381,58,122,0.475,15,40,0.375,43,82,0.524,0.537,31,40,0.775,14,30,44,53,21,5,16,43,162
378,Micah Potter\pottemi01,26,UTA,C,38,10,705,57,135,0.422,31,98,0.316,26,37,0.703,0.537,17,20,0.85,43,121,164,31,14,14,31,50,162
379,Daniel Theis\theisda01,32,NOP,C,38,9,621,61,129,0.473,9,37,0.243,52,92,0.565,0.508,31,37,0.838,44,120,164,60,18,20,25,70,162
380,Jordan Goodwin\goodwjo01,26,LAL,PG,29,5,543,63,144,0.438,26,68,0.382,37,76,0.487,0.528,9,11,0.818,38,74,112,42,30,11,26,43,161
381,Charles Bassey\bassech01,24,SAS,C,36,1,376,68,117,0.581,0,0,,68,117,0.581,0.581,21,33,0.636,56,96,152,17,14,30,23,50,157
382,Colby Jones\jonesco02,22,2TM,SG,39,0,515,59,129,0.457,16,49,0.327,43,80,0.538,0.519,23,35,0.657,21,66,87,44,26,13,23,37,157
382,Colby Jones\jonesco02,22,SAC,SG,24,0,130,11,26,0.423,4,10,0.4,7,16,0.438,0.5,0,0,,8,15,23,7,6,7,7,13,26
382,Colby Jones\jonesco02,22,WAS,SG,15,0,385,48,103,0.466,12,39,0.308,36,64,0.563,0.524,23,35,0.657,13,51,64,37,20,6,16,24,131
383,Rayan Rupert\ruperra01,20,POR,SG,52,0,460,58,142,0.408,16,59,0.271,42,83,0.506,0.465,23,30,0.767,26,44,70,25,16,4,30,37,155
384,Jevon Carter\carteje01,29,CHI,PG,36,1,321,55,146,0.377,35,105,0.333,20,41,0.488,0.497,8,10,0.8,4,35,39,40,13,3,11,15,153
385,David Roddy\roddyda01,23,3TM,PF,33,3,410,57,125,0.456,19,61,0.311,38,64,0.594,0.532,20,26,0.769,13,71,84,35,14,9,22,20,153
385,David Roddy\roddyda01,23,ATL,PF,27,3,346,44,93,0.473,16,43,0.372,28,50,0.56,0.559,18,22,0.818,11,59,70,30,12,8,20,18,122
385,David Roddy\roddyda01,23,PHI,PF,3,0,29,8,19,0.421,2,11,0.182,6,8,0.75,0.474,0,0,,2,7,9,3,2,0,1,1,18
385,David Roddy\roddyda01,23,HOU,PF,3,0,35,5,13,0.385,1,7,0.143,4,6,0.667,0.423,2,4,0.5,0,5,5,2,0,1,1,1,13
386,Jordan Miller\millejo02,25,LAC,SF,37,0,420,58,134,0.433,8,38,0.211,50,96,0.521,0.463,28,35,0.8,23,35,58,34,17,5,26,26,152
387,Trevelin Queen\queentr01,27,ORL,SG,31,2,430,56,147,0.381,22,77,0.286,34,70,0.486,0.456,18,21,0.857,26,28,54,38,31,10,22,38,152
388,Wendell Moore Jr.\moorewe01,23,2TM,SG,36,1,499,59,126,0.468,14,41,0.341,45,85,0.529,0.524,18,22,0.818,30,65,95,42,20,5,27,31,150
388,Wendell Moore Jr.\moorewe01,23,DET,SG,20,1,219,23,50,0.46,4,14,0.286,19,36,0.528,0.5,13,14,0.929,11,33,44,23,10,3,9,15,63
388,Wendell Moore Jr.\moorewe01,23,CHO,SG,16,0,280,36,76,0.474,10,27,0.37,26,49,0.531,0.539,5,8,0.625,19,32,51,19,10,2,18,16,87
389,Bones Hyland\hylanbo01,24,2TM,PG,24,0,239,47,118,0.398,32,82,0.39,15,36,0.417,0.534,23,26,0.885,5,20,25,32,18,4,25,29,149
389,Bones Hyland\hylanbo01,24,LAC,PG,20,0,222,45,115,0.391,31,80,0.388,14,35,0.4,0.526,23,26,0.885,5,19,24,28,18,4,24,26,144
389,Bones Hyland\hylanbo01,24,MIN,PG,4,0,17,2,3,0.667,1,2,0.5,1,1,1.0,0.833,0,0,,0,1,1,4,0,0,1,3,5
390,Dominick Barlow\barlodo01,21,ATL,SF,35,4,375,60,113,0.531,7,27,0.259,53,86,0.616,0.562,21,33,0.636,35,50,85,19,9,16,5,47,148
391,Doug McDermott\mcderdo01,33,SAC,SF,42,3,342,50,117,0.427,44,101,0.436,6,16,0.375,0.615,3,5,0.6,3,19,22,7,4,2,6,30,147
392,Jarred Vanderbilt\vandeja01,25,LAL,PF,36,2,581,59,121,0.488,9,32,0.281,50,89,0.562,0.525,20,36,0.556,68,114,182,41,35,10,29,67,147
393,Gary Harris\harriga01,30,ORL,SG,48,3,711,51,133,0.383,36,101,0.356,15,32,0.469,0.519,7,12,0.583,20,44,64,30,26,12,17,45,145
394,Bismack Biyombo\biyombi01,32,SAS,C,28,26,528,67,114,0.588,0,0,,67,114,0.588,0.588,10,25,0.4,43,115,158,31,16,23,27,52,144
395,Keion Brooks Jr.\brookke02,24,NOP,SF,14,6,332,53,109,0.486,14,43,0.326,39,66,0.591,0.55,22,30,0.733,12,46,58,13,10,10,12,30,142
396,Ousmane Dieng\diengou01,21,OKC,C,37,1,405,54,125,0.432,23,71,0.324,31,54,0.574,0.524,11,16,0.688,18,63,81,31,17,7,18,33,142
397,Devin Carter\cartede02,22,SAC,PG,36,0,396,47,127,0.37,18,61,0.295,29,66,0.439,0.441,26,44,0.591,19,57,76,41,21,4,18,39,138
398,Luka Garza\garzalu01,26,MIN,C,39,0,219,52,105,0.495,10,36,0.278,42,69,0.609,0.543,24,35,0.686,31,23,54,11,6,3,12,29,138
399,Kyle Lowry\lowryky01,38,PHI,PG,35,12,659,41,117,0.35,29,88,0.33,12,29,0.414,0.474,27,33,0.818,11,56,67,96,33,11,21,62,138
400,Terrence Shannon Jr.\shannte01,24,MIN,SG,32,1,339,55,114,0.482,11,31,0.355,44,83,0.53,0.531,17,21,0.81,10,37,47,32,7,5,15,27,138
401,Mo Bamba\bambamo01,26,2TM,C,32,2,413,52,112,0.464,15,54,0.278,37,58,0.638,0.531,19,27,0.704,32,113,145,18,9,31,20,56,138
401,Mo Bamba\bambamo01,26,LAC,C,28,2,352,48,103,0.466,15,50,0.3,33,53,0.623,0.539,17,25,0.68,26,94,120,16,9,28,19,49,128
401,Mo Bamba\bambamo01,26,NOP,C,4,0,61,4,9,0.444,0,4,0.0,4,5,0.8,0.444,2,2,1.0,6,19,25,2,0,3,1,7,10
402,Reggie Jackson\jacksre01,34,PHI,PG,31,1,384,52,133,0.391,25,74,0.338,27,59,0.458,0.485,7,9,0.778,8,34,42,45,16,3,17,34,136
403,Marvin Bagley III\baglema01,25,2TM,PF,31,2,265,55,106,0.519,3,19,0.158,52,87,0.598,0.533,23,35,0.657,38,46,84,11,9,8,12,18,136
403,Marvin Bagley III\baglema01,25,WAS,C,19,1,166,38,71,0.535,2,10,0.2,36,61,0.59,0.549,15,23,0.652,27,29,56,7,7,5,11,12,93
403,Marvin Bagley III\baglema01,25,MEM,PF,12,1,99,17,35,0.486,1,9,0.111,16,26,0.615,0.5,8,12,0.667,11,17,28,4,2,3,1,6,43
404,Dillon Jones\jonesdi01,23,OKC,SF,54,3,551,51,133,0.383,16,63,0.254,35,70,0.5,0.444,17,28,0.607,30,91,121,58,16,4,28,54,135
405,Isaac Jones\jonesis01,24,SAC,PF,40,0,304,54,83,0.651,3,8,0.375,51,75,0.68,0.669,23,36,0.639,22,35,57,12,5,10,16,30,134
406,Hunter Tyson\tysonhu01,24,DEN,PF,51,2,400,45,120,0.375,23,74,0.311,22,46,0.478,0.471,21,28,0.75,25,53,78,20,10,6,14,44,134
407,Anthony Gill\gillan01,32,WAS,PF,51,0,397,43,88,0.489,10,31,0.323,33,57,0.579,0.545,33,50,0.66,18,48,66,16,9,2,10,30,129
408,Delon Wright\wrighde01,32,2TM,PG,40,7,635,45,131,0.344,20,73,0.274,25,58,0.431,0.42,15,25,0.6,27,39,66,77,35,12,22,25,125
408,Delon Wright\wrighde01,32,MIL,PG,26,2,405,22,82,0.268,12,49,0.245,10,33,0.303,0.341,9,16,0.563,15,31,46,48,23,9,14,17,65
408,Delon Wright\wrighde01,32,NYK,PG,14,5,230,23,49,0.469,8,24,0.333,15,25,0.6,0.551,6,9,0.667,12,8,20,29,12,3,8,8,60
409,Colin Castleton\castlco01,24,3TM,C,26,4,432,46,98,0.469,2,16,0.125,44,82,0.537,0.48,29,38,0.763,53,69,122,28,8,10,23,51,123
409,Colin Castleton\castlco01,24,MEM,C,10,0,46,2,10,0.2,0,4,0.0,2,6,0.333,0.2,10,11,0.909,3,6,9,0,1,1,1,6,14
409,Colin Castleton\castlco01,24,TOR,C,11,4,288,32,64,0.5,2,8,0.25,30,56,0.536,0.516,13,18,0.722,34,42,76,18,6,8,21,32,79
409,Colin Castleton\castlco01,24,PHI,C,5,0,98,12,24,0.5,0,4,0.0,12,20,0.6,0.5,6,9,0.667,16,21,37,10,1,1,1,13,30
410,Branden Carlson\carlsbr01,25,OKC,C,32,0,246,43,97,0.443,22,66,0.333,21,31,0.677,0.557,14,18,0.778,17,37,54,14,5,21,7,22,122
411,Kevin Love\loveke01,36,MIA,PF,23,9,251,41,115,0.357,24,67,0.358,17,48,0.354,0.461,16,23,0.696,22,72,94,22,15,4,14,21,122
412,Isaiah Wong\wongis01,24,CHO,SG,20,0,265,41,105,0.39,13,33,0.394,28,72,0.389,0.452,25,34,0.735,14,18,32,28,11,0,18,21,120
413,Josh Minott\minotjo01,22,MIN,SF,46,0,276,44,90,0.489,14,43,0.326,30,47,0.638,0.567,17,19,0.895,12,35,47,18,15,12,11,34,119
414,Jared Rhoden\rhodeja01,25,2TM,SG,14,2,227,42,87,0.483,12,39,0.308,30,48,0.625,0.552,22,25,0.88,14,28,42,16,10,2,9,20,118
414,Jared Rhoden\rhodeja01,25,CHO,SG,4,0,12,2,8,0.25,0,2,0.0,2,6,0.333,0.25,0,0,,2,2,4,2,1,0,1,1,4
414,Jared Rhoden\rhodeja01,25,TOR,SG,10,2,215,40,79,0.506,12,37,0.324,28,42,0.667,0.582,22,25,0.88,12,26,38,14,9,2,8,19,114
415,Robert Williams\williro04,27,POR,C,20,3,351,50,78,0.641,1,3,0.333,49,75,0.653,0.647,15,17,0.882,35,83,118,21,13,33,17,31,116
416,Maxwell Lewis\lewisma05,22,2TM,SF,28,1,327,45,108,0.417,19,50,0.38,26,58,0.448,0.505,7,10,0.7,18,37,55,19,9,7,14,29,116
416,Maxwell Lewis\lewisma05,22,LAL,SF,7,0,29,2,6,0.333,0,0,,2,6,0.333,0.333,0,0,,2,0,2,2,1,0,2,1,4
416,Maxwell Lewis\lewisma05,22,BRK,SF,21,1,298,43,102,0.422,19,50,0.38,24,52,0.462,0.515,7,10,0.7,16,37,53,17,8,7,12,28,112
417,Dariq Whitehead\whiteda01,20,BRK,SF,20,0,246,39,96,0.406,33,74,0.446,6,22,0.273,0.578,3,5,0.6,4,25,29,12,6,1,15,22,114
418,Dwight Powell\poweldw01,33,DAL,C,55,3,551,42,61,0.689,2,5,0.4,40,56,0.714,0.705,28,43,0.651,47,71,118,55,18,21,18,75,114
419,Baylor Scheierman\scheiba01,24,BOS,SG,31,2,384,39,110,0.355,26,82,0.317,13,28,0.464,0.473,9,12,0.75,19,46,65,33,17,2,12,22,113
420,John Konchar\konchjo01,28,MEM,SG,46,4,558,41,91,0.451,23,62,0.371,18,29,0.621,0.577,7,8,0.875,37,114,151,42,30,14,16,32,112
421,Matisse Thybulle\thybuma01,27,POR,SG,15,5,312,42,88,0.477,21,48,0.438,21,40,0.525,0.597,7,15,0.467,14,38,52,28,33,9,13,14,112
422,Patty Mills\millspa02,36,2TM,PG,29,0,321,36,96,0.375,26,75,0.347,10,21,0.476,0.51,13,14,0.929,4,18,22,26,13,3,17,24,111
422,Patty Mills\millspa02,36,UTA,PG,17,0,260,26,76,0.342,17,57,0.298,9,19,0.474,0.454,5,5,1.0,3,18,21,21,12,3,16,12,74
422,Patty Mills\millspa02,36,LAC,PG,12,0,61,10,20,0.5,9,18,0.5,1,2,0.5,0.725,8,9,0.889,1,0,1,5,1,0,1,12,37
423,Damion Baugh\baughda01,24,CHO,SG,15,2,370,42,130,0.323,12,56,0.214,30,74,0.405,0.369,13,15,0.867,14,36,50,56,15,2,31,22,109
424,Drew Timme\timmedr01,24,BRK,PF,9,2,254,45,102,0.441,9,35,0.257,36,67,0.537,0.485,10,16,0.625,17,48,65,20,4,1,15,21,109
425,Jaden Springer\sprinja01,22,2TM,SG,43,2,365,35,90,0.389,12,48,0.25,23,42,0.548,0.456,27,38,0.711,17,41,58,33,24,4,16,42,109
425,Jaden Springer\sprinja01,22,BOS,SG,26,0,141,12,34,0.353,6,19,0.316,6,15,0.4,0.441,15,21,0.714,4,20,24,10,12,1,4,17,45
425,Jaden Springer\sprinja01,22,UTA,PG,17,2,224,23,56,0.411,6,29,0.207,17,27,0.63,0.464,12,17,0.706,13,21,34,23,12,3,12,25,64
426,Torrey Craig\craigto01,34,2TM,SF,26,4,314,38,90,0.422,24,66,0.364,14,24,0.583,0.556,8,12,0.667,27,46,73,17,8,12,8,34,108
426,Torrey Craig\craigto01,34,CHI,SF,9,1,113,22,45,0.489,15,35,0.429,7,10,0.7,0.656,3,4,0.75,8,17,25,5,2,1,0,15,62
426,Torrey Craig\craigto01,34,BOS,SF,17,3,201,16,45,0.356,9,31,0.29,7,14,0.5,0.456,5,8,0.625,19,29,48,12,6,11,8,19,46
427,Taj Gibson\gibsota01,39,CHO,C,37,11,409,47,95,0.495,1,2,0.5,46,93,0.495,0.5,12,20,0.6,51,69,120,21,9,18,25,54,107
428,Oscar Tshiebwe\tshieos01,25,UTA,C,14,1,255,42,70,0.6,0,0,,42,70,0.6,0.6,23,31,0.742,46,76,122,9,13,1,10,24,107
429,Cam Spencer\spencca01,24,MEM,SG,25,1,252,34,82,0.415,19,53,0.358,15,29,0.517,0.53,19,19,1.0,12,18,30,34,9,1,6,23,106
430,Jalen Hood-Schifino\hoodsja01,21,2TM,SG,15,0,315,37,98,0.378,14,46,0.304,23,52,0.442,0.449,18,21,0.857,3,24,27,37,5,7,18,25,106
430,Jalen Hood-Schifino\hoodsja01,21,LAL,SG,2,0,14,1,1,1.0,0,0,,1,1,1.0,1.0,2,2,1.0,1,0,1,1,0,1,1,3,4
430,Jalen Hood-Schifino\hoodsja01,21,PHI,SG,13,0,301,36,97,0.371,14,46,0.304,22,51,0.431,0.443,16,19,0.842,2,24,26,36,5,6,17,22,102
431,Cam Reddish\reddica01,25,LAL,SF,33,8,589,38,94,0.404,13,47,0.277,25,47,0.532,0.473,16,26,0.615,17,49,66,22,33,10,12,43,105
432,Johnny Furphy\furphjo01,20,IND,SG,50,0,379,35,92,0.38,15,50,0.3,20,42,0.476,0.462,18,22,0.818,23,48,71,19,18,11,12,41,103
433,Maxi Kleber\klebima01,33,DAL,PF,34,4,637,37,96,0.385,13,49,0.265,24,47,0.511,0.453,16,21,0.762,25,70,95,43,9,17,23,66,103
434,Pat Spencer\spencpa01,28,GSW,PG,39,0,250,41,101,0.406,5,22,0.227,36,79,0.456,0.431,11,15,0.733,15,31,46,48,14,3,18,20,98
435,Jericho Sims\simsje01,26,2TM,C,53,5,632,45,71,0.634,0,0,,45,71,0.634,0.634,8,13,0.615,71,126,197,33,10,19,33,65,98
435,Jericho Sims\simsje01,26,NYK,C,39,5,422,28,46,0.609,0,0,,28,46,0.609,0.609,8,13,0.615,51,78,129,22,8,10,21,46,64
435,Jericho Sims\simsje01,26,MIL,C,14,0,210,17,25,0.68,0,0,,17,25,0.68,0.68,0,0,,20,48,68,11,2,9,12,19,34
436,Jordan McLaughlin\mclaujo01,28,2TM,PG,46,0,314,31,72,0.431,19,46,0.413,12,26,0.462,0.563,17,22,0.773,6,24,30,51,16,1,16,18,98
436,Jordan McLaughlin\mclaujo01,28,SAC,PG,28,0,190,16,44,0.364,10,26,0.385,6,18,0.333,0.477,11,16,0.688,4,17,21,24,11,0,11,13,53
436,Jordan McLaughlin\mclaujo01,28,SAS,PG,18,0,124,15,28,0.536,9,20,0.45,6,8,0.75,0.696,6,6,1.0,2,7,9,27,5,1,5,5,45
437,Trey Jemison\jemistr01,25,2TM,C,38,0,392,41,74,0.554,0,0,,41,74,0.554,0.554,13,33,0.394,44,61,105,16,9,15,24,69,95
437,Trey Jemison\jemistr01,25,NOP,C,16,0,166,15,32,0.469,0,0,,15,32,0.469,0.469,8,21,0.381,22,22,44,10,7,6,10,27,38
437,Trey Jemison\jemistr01,25,LAL,C,22,0,226,26,42,0.619,0,0,,26,42,0.619,0.619,5,12,0.417,22,39,61,6,2,9,14,42,57
438,Reece Beekman\beekmre01,23,2TM,PG,36,4,469,35,107,0.327,7,40,0.175,28,67,0.418,0.36,16,21,0.762,13,26,39,63,33,2,21,36,93
438,Reece Beekman\beekmre01,23,GSW,PG,2,0,4,1,1,1.0,0,0,,1,1,1.0,1.0,0,0,,1,0,1,1,1,0,0,1,2
438,Reece Beekman\beekmre01,23,BRK,PG,34,4,465,34,106,0.321,7,40,0.175,27,66,0.409,0.354,16,21,0.762,12,26,38,62,32,2,21,35,91
439,Christian Koloko\kolokch01,24,LAL,C,37,0,342,40,66,0.606,0,4,0.0,40,62,0.645,0.606,10,14,0.714,35,57,92,16,8,16,12,44,90
440,Mitchell Robinson\robinmi01,26,NYK,C,17,3,290,37,56,0.661,0,0,,37,56,0.661,0.661,13,19,0.684,52,49,101,13,16,18,10,26,87
441,Dru Smith\smithdr01,27,MIA,SG,14,1,268,31,61,0.508,16,30,0.533,15,31,0.484,0.639,9,12,0.75,12,24,36,23,21,6,17,30,87
442,Lester Quiñones\quinole01,24,2TM,SG,13,0,183,31,78,0.397,13,44,0.295,18,34,0.529,0.481,11,13,0.846,4,15,19,24,3,2,14,18,86
442,Lester Quiñones\quinole01,24,PHI,SG,4,0,17,4,8,0.5,0,3,0.0,4,5,0.8,0.5,1,1,1.0,3,1,4,1,0,0,4,0,9
442,Lester Quiñones\quinole01,24,NOP,SG,9,0,166,27,70,0.386,13,41,0.317,14,29,0.483,0.479,10,12,0.833,1,14,15,23,3,2,10,18,77
443,Elfrid Payton\paytoel01,30,2TM,PG,24,9,511,40,122,0.328,1,6,0.167,39,116,0.336,0.332,4,7,0.571,15,64,79,166,24,11,59,36,85
443,Elfrid Payton\paytoel01,30,NOP,PG,18,7,388,37,101,0.366,1,6,0.167,36,95,0.379,0.371,4,7,0.571,14,52,66,146,18,8,52,24,79
443,Elfrid Payton\paytoel01,30,CHO,PG,6,2,123,3,21,0.143,0,0,,3,21,0.143,0.143,0,0,,1,12,13,20,6,3,7,12,6
444,Damion Lee\leeda03,32,PHO,SG,25,0,144,27,74,0.365,9,37,0.243,18,37,0.486,0.426,20,21,0.952,3,17,20,11,6,0,10,6,83
445,Jordan Walsh\walshjo01,20,BOS,PF,52,1,403,30,83,0.361,15,55,0.273,15,28,0.536,0.452,7,12,0.583,23,46,69,19,12,11,17,30,82
446,Tyler Kolek\kolekty01,23,NYK,PG,41,0,296,27,82,0.329,14,47,0.298,13,35,0.371,0.415,13,17,0.765,8,19,27,70,12,4,18,26,81
447,Johnny Davis\davisjo06,22,WAS,SG,34,0,242,32,78,0.41,7,29,0.241,25,49,0.51,0.455,9,15,0.6,10,28,38,11,15,6,7,18,80
448,MarJon Beauchamp\beaucma01,24,3TM,SF,35,0,156,27,65,0.415,10,29,0.345,17,36,0.472,0.492,15,20,0.75,11,33,44,11,4,1,15,14,79
448,MarJon Beauchamp\beaucma01,24,MIL,SF,26,0,122,18,47,0.383,7,21,0.333,11,26,0.423,0.457,9,12,0.75,7,25,32,8,3,1,13,10,52
448,MarJon Beauchamp\beaucma01,24,LAC,SF,3,0,17,4,7,0.571,2,3,0.667,2,4,0.5,0.714,2,4,0.5,2,1,3,2,0,0,1,2,12
448,MarJon Beauchamp\beaucma01,24,NYK,SF,6,0,17,5,11,0.455,1,5,0.2,4,6,0.667,0.5,4,4,1.0,2,7,9,1,1,0,1,2,15
449,Jaylen Martin\martija02,21,2TM,SF,16,0,239,31,74,0.419,7,23,0.304,24,51,0.471,0.466,9,10,0.9,11,33,44,17,9,0,12,14,78
449,Jaylen Martin\martija02,21,BRK,SF,3,0,5,1,2,0.5,1,1,1.0,0,1,0.0,0.75,0,0,,0,0,0,0,0,0,0,1,3
449,Jaylen Martin\martija02,21,WAS,SF,13,0,234,30,72,0.417,6,22,0.273,24,50,0.48,0.458,9,10,0.9,11,33,44,17,9,0,12,13,75
450,Kobe Brown\brownko01,25,LAC,PF,40,0,272,33,72,0.458,6,26,0.231,27,46,0.587,0.5,5,7,0.714,19,46,65,24,7,4,12,23,77
451,Alex Reese\reeseal01,25,2TM,PF,15,0,216,26,54,0.481,15,41,0.366,11,13,0.846,0.62,9,12,0.75,9,38,47,4,10,10,6,21,76
451,Alex Reese\reeseal01,25,OKC,PF,1,0,2,1,1,1.0,0,0,,1,1,1.0,1.0,0,0,,1,0,1,0,0,0,0,0,2
451,Alex Reese\reeseal01,25,PHI,PF,14,0,214,25,53,0.472,15,41,0.366,10,12,0.833,0.613,9,12,0.75,8,38,46,4,10,10,6,21,74
452,Moses Brown\brownmo01,25,2TM,C,13,2,119,34,49,0.694,0,0,,34,49,0.694,0.694,8,11,0.727,12,32,44,2,6,4,11,17,76
452,Moses Brown\brownmo01,25,IND,C,9,0,46,13,20,0.65,0,0,,13,20,0.65,0.65,3,5,0.6,4,9,13,0,2,1,6,6,29
452,Moses Brown\brownmo01,25,DAL,C,4,2,73,21,29,0.724,0,0,,21,29,0.724,0.724,5,6,0.833,8,23,31,2,4,3,5,11,47
453,Lamar Stevens\stevela01,27,MEM,PF,17,1,155,29,63,0.46,8,27,0.296,21,36,0.583,0.524,8,11,0.727,4,34,38,8,5,3,10,15,74
454,Alex Len\lenal01,31,2TM,C,46,7,380,32,63,0.508,2,9,0.222,30,54,0.556,0.524,8,17,0.471,38,57,95,38,9,21,20,56,74
454,Alex Len\lenal01,31,SAC,C,36,3,258,22,41,0.537,1,6,0.167,21,35,0.6,0.549,7,13,0.538,25,39,64,30,8,18,11,35,52
454,Alex Len\lenal01,31,LAL,C,10,4,122,10,22,0.455,1,3,0.333,9,19,0.474,0.477,1,4,0.25,13,18,31,8,1,3,9,21,22
455,JT Thor\thorjt01,22,2TM,PF,20,0,249,25,59,0.424,6,21,0.286,19,38,0.5,0.475,15,22,0.682,20,28,48,6,8,9,9,17,71
455,JT Thor\thorjt01,22,CLE,PF,9,0,42,9,15,0.6,3,6,0.5,6,9,0.667,0.7,7,8,0.875,3,3,6,1,2,3,6,6,28
455,JT Thor\thorjt01,22,WAS,PF,11,0,207,16,44,0.364,3,15,0.2,13,29,0.448,0.398,8,14,0.571,17,25,42,5,6,6,3,11,43
456,Tristan Thompson\thomptr01,33,CLE,C,40,0,328,31,71,0.437,0,3,0.0,31,68,0.456,0.437,7,30,0.233,32,102,134,24,2,11,14,36,69
457,Marcus Bagley\baglema02,23,PHI,SF,10,4,253,27,69,0.391,5,32,0.156,22,37,0.595,0.428,8,10,0.8,23,47,70,10,9,12,7,16,67
458,Jaylen Nowell\nowelja01,25,NOP,SG,8,0,168,26,73,0.356,8,27,0.296,18,46,0.391,0.411,7,11,0.636,6,14,20,18,1,4,8,9,67
459,Tyler Smith\smithty02,20,MIL,PF,23,0,122,24,50,0.48,13,30,0.433,11,20,0.55,0.61,6,8,0.75,6,19,25,4,3,4,8,11,67
460,Adam Flagler\flaglad01,25,OKC,SG,37,0,203,25,96,0.26,14,72,0.194,11,24,0.458,0.333,1,2,0.5,7,20,27,12,8,3,4,15,65
461,Jeenathan Williams\willije02,25,HOU,SG,20,0,147,27,62,0.435,6,26,0.231,21,36,0.583,0.484,5,8,0.625,5,8,13,9,8,4,14,16,65
462,Bronny James\jamesbr02,20,LAL,SG,27,1,181,21,67,0.313,9,32,0.281,12,35,0.343,0.381,11,14,0.786,4,14,18,22,9,3,13,13,62
463,De'Anthony Melton\meltode01,26,GSW,SG,6,2,121,22,54,0.407,13,35,0.371,9,19,0.474,0.528,5,8,0.625,6,14,20,17,7,2,10,18,62
464,Tony Bradley\bradlto01,27,IND,C,14,0,113,29,45,0.644,1,3,0.333,28,42,0.667,0.656,2,6,0.333,18,24,42,6,2,9,5,11,61
465,Markelle Fultz\fultzma01,26,SAC,PG,21,0,184,28,67,0.418,4,8,0.5,24,59,0.407,0.448,1,1,1.0,6,14,20,27,10,2,15,12,61
466,Cole Swider\swideco01,25,2TM,SF,10,0,169,22,63,0.349,15,47,0.319,7,16,0.438,0.468,0,1,0.0,5,22,27,3,4,2,4,12,59
466,Cole Swider\swideco01,25,DET,SF,2,0,13,0,5,0.0,0,5,0.0,0,0,,0.0,0,0,,0,2,2,1,0,0,0,1,0
466,Cole Swider\swideco01,25,TOR,SF,8,0,156,22,58,0.379,15,42,0.357,7,16,0.438,0.509,0,1,0.0,5,20,25,2,4,2,4,11,59
467,Bruno Fernando\fernabr01,26,TOR,C,17,2,147,26,49,0.531,0,0,,26,49,0.531,0.531,6,8,0.75,21,30,51,18,4,9,14,27,58
468,Dario Šarić\saricda01,30,DEN,C,16,4,210,21,58,0.362,7,26,0.269,14,32,0.438,0.422,7,10,0.7,14,36,50,23,7,1,15,19,56
469,Markieff Morris\morrima02,35,2TM,PF,15,2,165,21,70,0.3,9,36,0.25,12,34,0.353,0.364,5,6,0.833,3,20,23,21,2,3,5,16,56
469,Markieff Morris\morrima02,35,DAL,PF,7,0,41,5,22,0.227,2,13,0.154,3,9,0.333,0.273,0,0,,0,8,8,4,1,1,2,2,12
469,Markieff Morris\morrima02,35,LAL,PF,8,2,124,16,48,0.333,7,23,0.304,9,25,0.36,0.406,5,6,0.833,3,12,15,17,1,2,3,14,44
470,Tyson Etienne\etienty01,25,BRK,PG,7,0,151,17,52,0.327,13,44,0.295,4,8,0.5,0.452,8,10,0.8,3,6,9,12,3,1,8,17,55
471,Killian Hayes\hayeski01,23,BRK,PG,6,5,162,18,43,0.419,8,21,0.381,10,22,0.455,0.512,10,12,0.833,5,13,18,31,4,4,9,13,54
472,Drew Peterson\peterdr01,25,BOS,PF,25,1,186,17,41,0.415,13,33,0.394,4,8,0.5,0.573,7,9,0.778,9,31,40,13,5,2,8,18,54
473,Kobe Bufkin\bufkiko01,21,ATL,SG,10,0,124,18,47,0.383,4,19,0.211,14,28,0.5,0.426,13,18,0.722,5,16,21,17,3,2,8,9,53
474,Garrett Temple\templga01,38,TOR,SG,28,0,227,18,60,0.3,6,28,0.214,12,32,0.375,0.35,11,12,0.917,9,20,29,31,17,2,10,23,53
475,Chuma Okeke\okekech01,26,2TM,PF,9,3,196,20,40,0.5,11,28,0.393,9,12,0.75,0.638,2,3,0.667,21,26,47,15,5,4,3,5,53
475,Chuma Okeke\okekech01,26,PHI,PF,7,3,171,18,33,0.545,10,22,0.455,8,11,0.727,0.697,2,3,0.667,20,23,43,13,5,3,3,5,48
475,Chuma Okeke\okekech01,26,CLE,PF,2,0,25,2,7,0.286,1,6,0.167,1,1,1.0,0.357,0,0,,1,3,4,2,0,1,0,0,5
476,Patrick Baldwin Jr.\baldwpa01,22,2TM,SF,24,0,107,19,35,0.543,13,23,0.565,6,12,0.5,0.729,2,4,0.5,5,20,25,3,3,2,5,7,53
476,Patrick Baldwin Jr.\baldwpa01,22,WAS,SF,22,0,101,17,33,0.515,11,21,0.524,6,12,0.5,0.682,2,4,0.5,5,17,22,2,3,2,5,5,47
476,Patrick Baldwin Jr.\baldwpa01,22,LAC,SF,2,0,6,2,2,1.0,2,2,1.0,0,0,,1.5,0,0,,0,3,3,1,0,0,0,2,6
477,Oshae Brissett\brissos01,26,PHI,SF,6,2,142,19,39,0.487,6,18,0.333,13,21,0.619,0.564,8,14,0.571,7,15,22,4,4,3,8,14,52
478,Ariel Hukporti\hukpoar01,22,NYK,C,25,1,217,21,31,0.677,0,0,,21,31,0.677,0.677,6,13,0.462,14,37,51,11,1,15,21,32,48
479,Enrique Freeman\freemen01,24,IND,PF,22,1,181,16,37,0.432,1,10,0.1,15,27,0.556,0.446,13,19,0.684,11,19,30,9,3,3,6,21,46
480,Kevin Knox\knoxke01,25,GSW,SF,14,0,84,18,36,0.5,4,15,0.267,14,21,0.667,0.556,6,8,0.75,7,10,17,5,2,4,4,6,46
481,Keshad Johnson\johnske10,23,MIA,SF,16,0,98,18,26,0.692,3,7,0.429,15,19,0.789,0.75,4,9,0.444,6,22,28,4,5,4,4,11,43
482,Daeqwon Plowden\plowdda01,26,ATL,SG,6,0,72,16,25,0.64,9,17,0.529,7,8,0.875,0.82,2,2,1.0,4,7,11,2,0,0,4,10,43
483,Jaylen Sims\simsja01,26,CHO,SG,6,0,112,12,28,0.429,6,15,0.4,6,13,0.462,0.536,12,15,0.8,3,3,6,12,3,1,8,10,42
484,Pete Nance\nancepe01,24,2TM,PF,13,1,138,14,32,0.438,9,24,0.375,5,8,0.625,0.578,1,2,0.5,5,16,21,10,2,2,4,17,38
484,Pete Nance\nancepe01,24,PHI,C,7,0,68,5,15,0.333,4,12,0.333,1,3,0.333,0.467,1,2,0.5,2,8,10,3,1,0,0,10,15
484,Pete Nance\nancepe01,24,MIL,PF,6,1,70,9,17,0.529,5,12,0.417,4,5,0.8,0.676,0,0,,3,8,11,7,1,2,4,7,23
485,Emoni Bates\batesem01,21,CLE,SF,10,0,75,13,38,0.342,11,30,0.367,2,8,0.25,0.487,0,0,,0,7,7,8,1,1,2,4,37
486,Chris Duarte\duartch01,27,CHI,SG,17,0,74,12,26,0.462,6,15,0.4,6,11,0.545,0.577,6,8,0.75,5,15,20,9,0,0,1,7,36
487,Alex Ducas\ducasal01,24,OKC,SG,21,0,125,12,30,0.4,10,21,0.476,2,9,0.222,0.567,2,2,1.0,9,17,26,5,5,0,4,12,36
488,Yuki Kawamura\kawamyu01,23,MEM,PG,22,0,93,11,30,0.367,7,23,0.304,4,7,0.571,0.483,7,9,0.778,0,12,12,19,2,0,5,8,36
489,Nae'Qwan Tomlin\tomlina01,24,CLE,PF,5,1,63,13,32,0.406,2,10,0.2,11,22,0.5,0.438,8,11,0.727,9,12,21,2,0,1,2,9,36
490,Isaiah Jackson\jacksis01,23,IND,C,5,1,84,14,23,0.609,0,0,,14,23,0.609,0.609,7,14,0.5,11,17,28,5,3,8,5,14,35
491,TyTy Washington Jr.\washity02,23,PHO,PG,16,0,118,14,45,0.311,4,21,0.19,10,24,0.417,0.356,3,6,0.5,4,9,13,16,3,0,3,4,35
492,Xavier Tillman Sr.\tillmxa01,26,BOS,C,33,2,231,13,53,0.245,5,32,0.156,8,21,0.381,0.292,3,4,0.75,10,33,43,7,11,5,14,18,34
493,Kylor Kelley\kelleky01,27,2TM,C,11,2,126,14,22,0.636,0,0,,14,22,0.636,0.636,6,10,0.6,12,27,39,5,1,3,4,15,34
493,Kylor Kelley\kelleky01,27,DAL,C,8,1,67,10,13,0.769,0,0,,10,13,0.769,0.769,4,6,0.667,8,13,21,2,0,2,1,8,24
493,Kylor Kelley\kelleky01,27,NOP,C,3,1,59,4,9,0.444,0,0,,4,9,0.444,0.444,2,4,0.5,4,14,18,3,1,1,3,7,10
494,JD Davison\davisjd01,22,BOS,PG,16,0,93,12,34,0.353,4,18,0.222,8,16,0.5,0.412,5,7,0.714,2,11,13,13,5,1,13,2,33
495,PJ Hall\hallpj01,22,DEN,C,19,0,66,14,24,0.583,2,8,0.25,12,16,0.75,0.625,3,4,0.75,6,16,22,4,0,4,2,11,33
496,Trey Alexander\alexatr01,21,DEN,SG,24,0,117,13,41,0.317,3,17,0.176,10,24,0.417,0.354,3,4,0.75,1,11,12,11,2,1,5,10,32
497,Elijah Harkless\harklej01,24,UTA,SG,10,0,138,11,35,0.314,7,25,0.28,4,10,0.4,0.414,3,6,0.5,9,12,21,8,10,1,3,18,32
498,Josh Richardson\richajo01,31,MIA,SG,8,0,150,11,38,0.289,6,22,0.273,5,16,0.313,0.368,4,4,1.0,6,6,12,12,8,1,8,17,32
499,Sidy Cissoko\cissosi01,20,2TM,SF,22,0,114,13,30,0.433,3,13,0.231,10,17,0.588,0.483,3,9,0.333,8,13,21,15,2,1,11,10,32
499,Sidy Cissoko\cissosi01,20,SAS,SF,17,0,54,9,18,0.5,3,7,0.429,6,11,0.545,0.583,1,6,0.167,3,7,10,6,1,0,2,6,22
499,Sidy Cissoko\cissosi01,20,POR,SF,5,0,60,4,12,0.333,0,6,0.0,4,6,0.667,0.333,2,3,0.667,5,6,11,9,1,1,9,4,10
500,Pacome Dadiet\dadiepa01,19,NYK,SG,18,0,111,10,31,0.323,6,19,0.316,4,12,0.333,0.419,4,6,0.667,3,15,18,5,3,2,4,7,30
501,RayJ Dennis\dennira01,23,IND,PG,11,0,70,11,33,0.333,6,21,0.286,5,12,0.417,0.424,2,2,1.0,2,10,12,14,7,2,5,7,30
502,Chris Livingston\livinch01,21,MIL,SF,21,1,106,9,27,0.333,0,8,0.0,9,19,0.474,0.333,12,16,0.75,10,25,35,5,5,0,6,8,30
503,Josh Christopher\chrisjo01,23,MIA,SG,14,0,69,11,31,0.355,2,11,0.182,9,20,0.45,0.387,4,6,0.667,0,9,9,8,5,3,6,2,28
504,Marcus Garrett\garrema01,26,CHO,SG,4,0,79,11,27,0.407,3,8,0.375,8,19,0.421,0.463,3,4,0.75,1,5,6,13,3,2,6,10,28
505,Matt Ryan\ryanma01,27,NYK,SF,19,0,68,10,31,0.323,6,19,0.316,4,12,0.333,0.419,2,2,1.0,0,8,8,3,2,0,3,1,28
506,Spencer Jones\jonessp01,23,DEN,SF,20,0,125,11,34,0.324,1,17,0.059,10,17,0.588,0.338,3,3,1.0,8,9,17,5,5,5,5,17,26
507,Vlatko Čančar\cancavl01,27,DEN,PF,13,0,136,10,26,0.385,4,15,0.267,6,11,0.545,0.462,0,0,,6,26,32,9,3,2,11,10,24
508,N'Faly Dante\nfalyda01,23,HOU,C,4,0,51,10,13,0.769,0,0,,10,13,0.769,0.769,4,5,0.8,6,15,21,2,1,5,2,9,24
509,Jazian Gortman\gortmja01,21,DAL,PG,16,0,57,9,23,0.391,4,11,0.364,5,12,0.417,0.478,2,4,0.5,1,4,5,6,2,1,5,9,24
510,Jae Crowder\crowdja01,34,SAC,PF,9,2,103,7,22,0.318,4,15,0.267,3,7,0.429,0.409,5,6,0.833,6,14,20,6,3,0,4,10,23
511,Mason Jones\jonesma05,26,SAC,SG,10,0,45,9,18,0.5,1,8,0.125,8,10,0.8,0.528,4,5,0.8,2,7,9,11,0,1,1,3,23
512,Jacob Toppin\toppija01,24,2TM,SF,17,0,76,9,22,0.409,5,10,0.5,4,12,0.333,0.523,0,0,,3,12,15,6,2,0,3,3,23
512,Jacob Toppin\toppija01,24,NYK,SF,16,0,49,3,10,0.3,0,2,0.0,3,8,0.375,0.3,0,0,,2,9,11,4,2,0,2,3,6
512,Jacob Toppin\toppija01,24,ATL,SF,1,0,27,6,12,0.5,5,8,0.625,1,4,0.25,0.708,0,0,,1,3,4,2,0,0,1,0,17
513,Jackson Rowe\roweja01,28,GSW,PF,6,0,52,8,17,0.471,3,10,0.3,5,7,0.714,0.559,3,6,0.5,3,8,11,4,4,0,1,4,22
514,E.J. Liddell\liddeej01,24,CHI,PF,12,0,53,8,15,0.533,3,10,0.3,5,5,1.0,0.633,2,2,1.0,3,6,9,3,1,1,2,11,21
515,Leonard Miller\millele01,21,MIN,SF,13,0,32,6,15,0.4,0,5,0.0,6,10,0.6,0.4,8,8,1.0,3,8,11,0,2,1,2,2,20
516,Cam Christie\chrisca02,19,LAC,SG,13,0,59,7,24,0.292,2,13,0.154,5,11,0.455,0.333,2,4,0.5,3,9,12,6,5,1,2,4,18
517,Justin Minaya\minayju01,25,POR,SF,19,0,101,8,21,0.381,2,10,0.2,6,11,0.545,0.429,0,2,0.0,5,5,10,7,6,1,5,12,18
518,Jamaree Bouyea\bouyeja01,25,MIL,PG,5,1,62,6,12,0.5,1,5,0.2,5,7,0.714,0.542,4,6,0.667,1,4,5,10,4,2,8,2,17
519,David Duke Jr.\dukeda01,25,SAS,SG,6,0,34,6,14,0.429,3,6,0.5,3,8,0.375,0.536,1,2,0.5,1,4,5,4,1,0,2,1,16
520,Malachi Flynn\flynnma01,26,CHO,PG,4,0,44,5,13,0.385,1,4,0.25,4,9,0.444,0.423,5,6,0.833,3,4,7,7,3,0,4,4,16
521,Joe Ingles\inglejo01,37,MIN,SF,19,1,114,6,23,0.261,3,15,0.2,3,8,0.375,0.326,0,0,,2,9,11,23,2,0,9,12,15
522,Bobi Klintman\klintbo01,21,DET,SF,8,0,42,6,10,0.6,2,5,0.4,4,5,0.8,0.7,1,2,0.5,1,6,7,7,2,1,1,8,15
523,Stanley Umude\umudest01,25,MIL,SG,22,0,86,5,26,0.192,3,15,0.2,2,11,0.182,0.25,2,4,0.5,4,13,17,4,3,6,3,8,15
524,Taylor Hendricks\hendrta01,21,UTA,PF,3,3,75,4,18,0.222,3,12,0.25,1,6,0.167,0.306,3,4,0.75,5,10,15,2,5,4,2,8,14
525,Jack McVeigh\mcveija01,28,HOU,PF,9,0,43,5,17,0.294,4,13,0.308,1,4,0.25,0.412,0,0,,2,3,5,1,0,2,2,3,14
526,Tolu Smith\smithto05,24,DET,PF,1,0,22,6,9,0.667,0,0,,6,9,0.667,0.667,2,3,0.667,4,4,8,0,0,0,2,3,14
527,Armel Traoré\armeltr01,22,LAL,SF,9,0,67,6,19,0.316,0,7,0.0,6,12,0.5,0.316,2,7,0.286,2,13,15,1,4,2,3,6,14
528,Isaiah Crawford\crawfis01,23,SAC,SF,15,0,46,5,11,0.455,1,5,0.2,4,6,0.667,0.5,2,4,0.5,1,7,8,1,1,2,1,2,13
529,Bryce McGowens\mcgowbr01,22,POR,SG,13,0,32,4,14,0.286,0,4,0.0,4,10,0.4,0.286,5,6,0.833,2,1,3,2,1,0,4,3,13
530,Luke Travers\travelu01,23,CLE,SG,12,0,88,5,20,0.25,0,9,0.0,5,11,0.455,0.25,2,2,1.0,8,12,20,8,1,1,8,6,12
531,Trentyn Flowers\flowetr01,19,LAC,SF,6,0,27,4,11,0.364,0,2,0.0,4,9,0.444,0.364,3,3,1.0,1,3,4,0,0,0,1,4,11
532,Jahmir Young\youngja05,24,CHI,PG,6,0,30,4,5,0.8,1,2,0.5,3,3,1.0,0.9,2,2,1.0,1,2,3,6,0,0,1,2,11
533,Emanuel Miller\milleem01,24,CHI,PF,6,0,25,4,8,0.5,0,1,0.0,4,7,0.571,0.5,2,2,1.0,4,4,8,2,1,0,0,3,10
534,Jalen Bridges\bridgja01,23,PHO,SF,8,0,30,2,7,0.286,2,7,0.286,0,0,,0.429,3,4,0.75,0,4,4,0,0,0,4,0,9
535,Liam Robbins\robbili01,25,MIL,C,13,0,57,2,8,0.25,0,2,0.0,2,6,0.333,0.25,5,10,0.5,7,5,12,2,2,2,6,9,9
536,P.J. Tucker\tuckepj01,39,NYK,SF,3,1,58,3,7,0.429,3,6,0.5,0,1,0.0,0.643,0,0,,4,4,8,0,1,1,1,8,9
537,James Johnson\johnsja01,37,IND,PF,12,0,37,4,11,0.364,0,3,0.0,4,8,0.5,0.364,0,1,0.0,0,6,6,4,0,2,4,5,8
538,Adama Sanogo\sanogad01,22,CHI,C,4,0,21,4,7,0.571,0,0,,4,7,0.571,0.571,0,0,,5,1,6,1,0,0,1,1,8
539,Anton Watson\watsoan02,24,NYK,SF,9,0,22,4,9,0.444,0,1,0.0,4,8,0.5,0.444,0,0,,1,2,3,2,1,0,2,3,8
540,Phillip Wheeler\wheelph02,22,PHI,PF,5,0,44,3,21,0.143,0,10,0.0,3,11,0.273,0.143,2,2,1.0,2,6,8,2,1,2,1,1,8
541,PJ Dozier\doziepj01,28,MIN,SG,9,0,35,2,3,0.667,2,3,0.667,0,0,,1.0,1,6,0.167,1,4,5,5,1,0,1,3,7
542,Daniss Jenkins\jenkida01,23,DET,PG,7,0,23,3,10,0.3,1,7,0.143,2,3,0.667,0.35,0,2,0.0,0,2,2,3,0,0,1,2,7
543,Miles Norris\norrimi01,24,BOS,PF,3,0,35,2,9,0.222,2,7,0.286,0,2,0.0,0.333,1,2,0.5,2,7,9,0,2,1,0,0,7
544,Kevin McCullar Jr.\mcculke01,23,NYK,SF,4,0,29,2,7,0.286,0,1,0.0,2,6,0.333,0.286,2,2,1.0,0,8,8,2,1,1,0,6,6
545,Isaiah Mobley\mobleis01,25,PHI,PF,1,0,17,2,7,0.286,1,3,0.333,1,4,0.25,0.357,1,2,0.5,1,3,4,5,1,1,0,3,6
546,Taze Moore\mooreta02,26,POR,SG,2,0,20,2,10,0.2,1,4,0.25,1,6,0.167,0.25,1,2,0.5,4,4,8,1,2,0,2,0,6
547,James Wiseman\wisemja01,23,IND,C,1,0,5,2,4,0.5,0,1,0.0,2,3,0.667,0.5,2,2,1.0,0,1,1,0,0,0,0,0,6
548,Ulrich Chomche\chomcul01,19,TOR,PF,7,0,32,2,5,0.4,0,0,,2,5,0.4,0.4,1,2,0.5,4,4,8,2,0,1,2,5,5
549,Skal Labissière\labissk01,28,SAC,PF,4,0,12,2,4,0.5,1,1,1.0,1,3,0.333,0.625,0,0,,1,2,3,1,0,0,0,1,5
550,Alondes Williams\willial06,25,DET,SG,1,0,4,2,2,1.0,1,1,1.0,1,1,1.0,1.25,0,0,,0,0,0,1,0,0,0,0,5
551,Ron Harper Jr.\harpero02,24,DET,SF,1,0,17,1,8,0.125,0,6,0.0,1,2,0.5,0.125,2,2,1.0,4,3,7,2,0,0,0,0,4
552,Harrison Ingram\ingraha01,22,SAS,SF,5,0,35,2,4,0.5,0,1,0.0,2,3,0.667,0.5,0,0,,2,7,9,3,3,0,1,2,4
553,D.J. Carton\cartodj01,24,TOR,SG,4,0,33,1,7,0.143,0,3,0.0,1,4,0.25,0.143,1,1,1.0,0,4,4,3,2,0,4,1,3
554,Cui Yongxi\cuiyo01,21,BRK,SG,5,0,10,1,7,0.143,0,3,0.0,1,4,0.25,0.143,1,2,0.5,0,2,2,0,0,0,0,0,3
555,Braxton Key\keybr01,27,GSW,SF,3,0,11,0,4,0.0,0,1,0.0,0,3,0.0,0.0,3,6,0.5,1,1,2,0,2,0,1,0,3
556,Tristen Newton\newtotr01,23,2TM,SG,8,0,16,1,8,0.125,0,3,0.0,1,5,0.2,0.125,1,1,1.0,2,2,4,2,1,0,2,4,3
556,Tristen Newton\newtotr01,23,IND,SG,5,0,8,1,6,0.167,0,3,0.0,1,3,0.333,0.167,1,1,1.0,0,0,0,1,0,0,1,2,3
556,Tristen Newton\newtotr01,23,MIN,SG,3,0,8,0,2,0.0,0,0,,0,2,0.0,0.0,0,0,,2,2,4,1,1,0,1,2,0
557,Quincy Olivari\olivaqu01,23,LAL,PG,2,0,10,1,5,0.2,1,5,0.2,0,0,,0.3,0,0,,0,0,0,1,0,0,1,0,3
558,Yuri Collins\colliyu01,23,GSW,PG,2,0,16,1,3,0.333,0,0,,1,3,0.333,0.333,0,0,,2,1,3,4,2,0,0,5,2
559,Malevy Leons\leonsma01,25,OKC,SF,6,0,21,0,2,0.0,0,1,0.0,0,1,0.0,0.0,2,4,0.5,1,2,3,1,0,0,1,4,2
560,Daishen Nix\nixda01,22,MIN,PG,3,0,13,0,1,0.0,0,1,0.0,0,0,,0.0,1,2,0.5,0,4,4,3,0,0,4,1,1
561,Terence Davis\daviste02,27,SAC,SG,1,0,8,0,2,0.0,0,1,0.0,0,1,0.0,0.0,0,0,,0,1,1,1,0,0,0,0,0
562,Jesse Edwards\edwarje01,24,MIN,C,2,0,5,0,0,,0,0,,0,0,,,0,0,,0,0,0,1,0,0,0,2,0
563,Mac McClung\mccluma01,26,ORL,SG,2,0,10,0,2,0.0,0,1,0.0,0,1,0.0,0.0,0,0,,0,1,1,3,0,0,0,2,0
564,Jalen McDaniels\mcdanja01,27,WAS,SF,4,0,7,0,0,,0,0,,0,0,,,0,0,,0,0,0,1,1,0,0,0,0
565,Riley Minix\minixri01,24,SAS,SF,1,0,7,0,1,0.0,0,1,0.0,0,0,,0.0,0,0,,0,2,2,0,0,0,0,0,0
566,Jahlil Okafor\okafoja01,29,IND,C,1,0,3,0,0,,0,0,,0,0,,,0,0,,0,1,1,1,0,0,0,0,0
567,Zyon Pullin\pullizy01,23,MEM,SG,3,0,3,0,1,0.0,0,0,,0,1,0.0,0.0,0,0,,0,0,0,0,0,0,0,0,0
568,Isaiah Stevens\steveis01,24,MIA,PG,3,0,6,0,2,0.0,0,1,0.0,0,1,0.0,0.0,0,0,,0,2,2,0,1,0,0,0,0
569,Terry Taylor\taylote01,25,SAC,PF,3,0,6,0,1,0.0,0,0,,0,1,0.0,0.0,0,0,,1,0,1,2,0,0,0,0,0
